Tema,Año,Mes,EntidadFederativa,UnidadesVehicularesElectricas,UnidadesVehicularesHibridasPlugin1,UnidadesVehicularesHibridas2,Total
Venta_de_vehiculos_hibridos_y_electricos,2019,Octubre,Ciudad_de_Mexico,15,66,933,1014
Venta_de_vehiculos_hibridos_y_electricos,2019,Junio,Ciudad_de_Mexico,5,18,804,827
Venta_de_vehiculos_hibridos_y_electricos,2019,Septiembre,Ciudad_de_Mexico,15,47,764,826
Venta_de_vehiculos_hibridos_y_electricos,2019,Julio,Ciudad_de_Mexico,7,26,716,749
Venta_de_vehiculos_hibridos_y_electricos,2018,Diciembre,Ciudad_de_Mexico,7,76,629,712
Venta_de_vehiculos_hibridos_y_electricos,2019,Marzo,Ciudad_de_Mexico,7,74,619,700
Venta_de_vehiculos_hibridos_y_electricos,2019,Agosto,Ciudad_de_Mexico,12,35,624,671
Venta_de_vehiculos_hibridos_y_electricos,2019,Enero,Ciudad_de_Mexico,13,89,535,637
Venta_de_vehiculos_hibridos_y_electricos,2018,Septiembre,Ciudad_de_Mexico,5,53,526,584
Venta_de_vehiculos_hibridos_y_electricos,2018,Noviembre,Ciudad_de_Mexico,8,64,511,583
Venta_de_vehiculos_hibridos_y_electricos,2018,Mayo,Ciudad_de_Mexico,3,108,455,566
Venta_de_vehiculos_hibridos_y_electricos,2018,Junio,Ciudad_de_Mexico,5,75,481,561
Venta_de_vehiculos_hibridos_y_electricos,2018,Octubre,Ciudad_de_Mexico,7,66,488,561
Venta_de_vehiculos_hibridos_y_electricos,2017,Diciembre,Ciudad_de_Mexico,3,58,495,556
Venta_de_vehiculos_hibridos_y_electricos,2017,Octubre,Ciudad_de_Mexico,15,46,469,530
Venta_de_vehiculos_hibridos_y_electricos,2016,Diciembre,Ciudad_de_Mexico,13,55,454,522
Venta_de_vehiculos_hibridos_y_electricos,2016,Septiembre,Ciudad_de_Mexico,4,49,463,516
Venta_de_vehiculos_hibridos_y_electricos,2018,Abril,Ciudad_de_Mexico,3,94,416,513
Venta_de_vehiculos_hibridos_y_electricos,2019,Octubre,Mexico,1,14,485,500
Venta_de_vehiculos_hibridos_y_electricos,2017,Marzo,Ciudad_de_Mexico,10,67,419,496
Venta_de_vehiculos_hibridos_y_electricos,2019,Febrero,Ciudad_de_Mexico,17,74,382,473
Venta_de_vehiculos_hibridos_y_electricos,2018,Julio,Ciudad_de_Mexico,6,56,407,469
Venta_de_vehiculos_hibridos_y_electricos,2018,Marzo,Ciudad_de_Mexico,4,114,350,468
Venta_de_vehiculos_hibridos_y_electricos,2018,Febrero,Ciudad_de_Mexico,4,66,391,461
Venta_de_vehiculos_hibridos_y_electricos,2019,Julio,Mexico,1,17,443,461
Venta_de_vehiculos_hibridos_y_electricos,2016,Junio,Ciudad_de_Mexico,16,20,407,443
Venta_de_vehiculos_hibridos_y_electricos,2018,Agosto,Ciudad_de_Mexico,9,7,423,439
Venta_de_vehiculos_hibridos_y_electricos,2019,Abril,Ciudad_de_Mexico,11,19,407,437
Venta_de_vehiculos_hibridos_y_electricos,2016,Noviembre,Ciudad_de_Mexico,6,46,370,422
Venta_de_vehiculos_hibridos_y_electricos,2017,Abril,Ciudad_de_Mexico,12,45,365,422
Venta_de_vehiculos_hibridos_y_electricos,2019,Junio,Mexico,6,6,407,419
Venta_de_vehiculos_hibridos_y_electricos,2019,Mayo,Ciudad_de_Mexico,7,27,375,409
Venta_de_vehiculos_hibridos_y_electricos,2016,Julio,Ciudad_de_Mexico,13,17,376,406
Venta_de_vehiculos_hibridos_y_electricos,2019,Septiembre,Mexico,4,6,396,406
Venta_de_vehiculos_hibridos_y_electricos,2016,Agosto,Ciudad_de_Mexico,10,30,364,404
Venta_de_vehiculos_hibridos_y_electricos,2017,Noviembre,Ciudad_de_Mexico,24,63,317,404
Venta_de_vehiculos_hibridos_y_electricos,2019,Marzo,Mexico,1,15,386,402
Venta_de_vehiculos_hibridos_y_electricos,2017,Junio,Ciudad_de_Mexico,10,47,316,373
Venta_de_vehiculos_hibridos_y_electricos,2017,Septiembre,Ciudad_de_Mexico,14,39,319,372
Venta_de_vehiculos_hibridos_y_electricos,2018,Diciembre,Mexico,2,13,357,372
Venta_de_vehiculos_hibridos_y_electricos,2016,Octubre,Ciudad_de_Mexico,17,39,304,360
Venta_de_vehiculos_hibridos_y_electricos,2017,Mayo,Ciudad_de_Mexico,12,40,307,359
Venta_de_vehiculos_hibridos_y_electricos,2018,Enero,Ciudad_de_Mexico,5,46,289,340
Venta_de_vehiculos_hibridos_y_electricos,2018,Septiembre,Mexico,0,17,297,314
Venta_de_vehiculos_hibridos_y_electricos,2017,Agosto,Ciudad_de_Mexico,10,38,263,311
Venta_de_vehiculos_hibridos_y_electricos,2017,Febrero,Ciudad_de_Mexico,13,56,234,303
Venta_de_vehiculos_hibridos_y_electricos,2016,Marzo,Ciudad_de_Mexico,7,0,283,290
Venta_de_vehiculos_hibridos_y_electricos,2019,Agosto,Mexico,3,9,275,287
Venta_de_vehiculos_hibridos_y_electricos,2019,Enero,Mexico,1,19,265,285
Venta_de_vehiculos_hibridos_y_electricos,2019,Febrero,Mexico,1,7,276,284
Venta_de_vehiculos_hibridos_y_electricos,2018,Noviembre,Mexico,1,8,264,273
Venta_de_vehiculos_hibridos_y_electricos,2017,Julio,Ciudad_de_Mexico,9,30,229,268
Venta_de_vehiculos_hibridos_y_electricos,2019,Octubre,Jalisco,0,15,244,259
Venta_de_vehiculos_hibridos_y_electricos,2018,Octubre,Mexico,0,11,246,257
Venta_de_vehiculos_hibridos_y_electricos,2017,Enero,Ciudad_de_Mexico,8,63,182,253
Venta_de_vehiculos_hibridos_y_electricos,2019,Septiembre,Jalisco,2,6,238,246
Venta_de_vehiculos_hibridos_y_electricos,2018,Agosto,Mexico,0,6,235,241
Venta_de_vehiculos_hibridos_y_electricos,2018,Diciembre,Jalisco,5,11,218,234
Venta_de_vehiculos_hibridos_y_electricos,2019,Abril,Mexico,0,4,221,225
Venta_de_vehiculos_hibridos_y_electricos,2018,Marzo,Mexico,0,12,209,221
Venta_de_vehiculos_hibridos_y_electricos,2019,Junio,Jalisco,2,2,217,221
Venta_de_vehiculos_hibridos_y_electricos,2018,Abril,Mexico,0,13,195,208
Venta_de_vehiculos_hibridos_y_electricos,2018,Julio,Mexico,0,9,193,202
Venta_de_vehiculos_hibridos_y_electricos,2016,Abril,Ciudad_de_Mexico,19,18,164,201
Venta_de_vehiculos_hibridos_y_electricos,2018,Mayo,Mexico,1,7,185,193
Venta_de_vehiculos_hibridos_y_electricos,2019,Mayo,Mexico,0,4,186,190
Venta_de_vehiculos_hibridos_y_electricos,2018,Junio,Mexico,0,12,177,189
Venta_de_vehiculos_hibridos_y_electricos,2019,Julio,Jalisco,1,8,176,185
Venta_de_vehiculos_hibridos_y_electricos,2019,Septiembre,Nuevo_Leon,0,11,168,179
Venta_de_vehiculos_hibridos_y_electricos,2017,Marzo,Mexico,1,2,175,178
Venta_de_vehiculos_hibridos_y_electricos,2019,Enero,Jalisco,16,13,148,177
Venta_de_vehiculos_hibridos_y_electricos,2017,Diciembre,Mexico,1,6,168,175
Venta_de_vehiculos_hibridos_y_electricos,2018,Junio,No especificado,14,0,159,173
Venta_de_vehiculos_hibridos_y_electricos,2019,Marzo,Jalisco,2,10,159,171
Venta_de_vehiculos_hibridos_y_electricos,2018,Febrero,Mexico,0,8,161,169
Venta_de_vehiculos_hibridos_y_electricos,2018,Octubre,Jalisco,3,8,156,167
Venta_de_vehiculos_hibridos_y_electricos,2016,Mayo,Ciudad_de_Mexico,11,10,143,164
Venta_de_vehiculos_hibridos_y_electricos,2018,Noviembre,Jalisco,3,9,151,163
Venta_de_vehiculos_hibridos_y_electricos,2019,Agosto,Jalisco,1,4,156,161
Venta_de_vehiculos_hibridos_y_electricos,2016,Agosto,Mexico,0,2,158,160
Venta_de_vehiculos_hibridos_y_electricos,2018,Septiembre,Jalisco,1,11,141,153
Venta_de_vehiculos_hibridos_y_electricos,2016,Junio,Mexico,5,1,145,151
Venta_de_vehiculos_hibridos_y_electricos,2018,Mayo,Jalisco,0,21,125,146
Venta_de_vehiculos_hibridos_y_electricos,2017,Diciembre,Jalisco,3,7,130,140
Venta_de_vehiculos_hibridos_y_electricos,2018,Enero,Mexico,0,6,133,139
Venta_de_vehiculos_hibridos_y_electricos,2016,Noviembre,Mexico,2,1,135,138
Venta_de_vehiculos_hibridos_y_electricos,2016,Diciembre,Mexico,0,7,131,138
Venta_de_vehiculos_hibridos_y_electricos,2016,Junio,Jalisco,3,6,128,137
Venta_de_vehiculos_hibridos_y_electricos,2018,Diciembre,Michoacan_de_Ocampo,2,1,134,137
Venta_de_vehiculos_hibridos_y_electricos,2019,Octubre,Nuevo_Leon,3,15,115,133
Venta_de_vehiculos_hibridos_y_electricos,2017,Noviembre,Mexico,1,5,126,132
Venta_de_vehiculos_hibridos_y_electricos,2019,Febrero,Jalisco,5,16,107,128
Venta_de_vehiculos_hibridos_y_electricos,2017,Abril,Mexico,2,2,123,127
Venta_de_vehiculos_hibridos_y_electricos,2017,Febrero,Mexico,2,0,124,126
Venta_de_vehiculos_hibridos_y_electricos,2017,Junio,Mexico,0,2,124,126
Venta_de_vehiculos_hibridos_y_electricos,2018,Marzo,Jalisco,4,22,100,126
Venta_de_vehiculos_hibridos_y_electricos,2016,Julio,Mexico,1,0,122,123
Venta_de_vehiculos_hibridos_y_electricos,2018,Junio,Jalisco,0,26,96,122
Venta_de_vehiculos_hibridos_y_electricos,2017,Mayo,Mexico,1,10,107,118
Venta_de_vehiculos_hibridos_y_electricos,2019,Septiembre,Michoacan_de_Ocampo,0,3,111,114
Venta_de_vehiculos_hibridos_y_electricos,2019,Agosto,Nuevo_Leon,1,7,105,113
Venta_de_vehiculos_hibridos_y_electricos,2019,Marzo,Nuevo_Leon,2,12,98,112
Venta_de_vehiculos_hibridos_y_electricos,2019,Junio,Michoacan_de_Ocampo,1,4,107,112
Venta_de_vehiculos_hibridos_y_electricos,2017,Mayo,Jalisco,0,4,107,111
Venta_de_vehiculos_hibridos_y_electricos,2018,Abril,Jalisco,0,19,91,110
Venta_de_vehiculos_hibridos_y_electricos,2019,Abril,Jalisco,5,3,98,106
Venta_de_vehiculos_hibridos_y_electricos,2018,Diciembre,Nuevo_Leon,3,19,82,104
Venta_de_vehiculos_hibridos_y_electricos,2016,Octubre,Mexico,1,5,96,102
Venta_de_vehiculos_hibridos_y_electricos,2019,Mayo,Jalisco,4,1,97,102
Venta_de_vehiculos_hibridos_y_electricos,2018,Febrero,Jalisco,0,8,93,101
Venta_de_vehiculos_hibridos_y_electricos,2017,Septiembre,Mexico,0,9,91,100
Venta_de_vehiculos_hibridos_y_electricos,2018,Noviembre,Michoacan_de_Ocampo,0,1,99,100
Venta_de_vehiculos_hibridos_y_electricos,2019,Marzo,Michoacan_de_Ocampo,0,2,98,100
Venta_de_vehiculos_hibridos_y_electricos,2017,Agosto,Nuevo_Leon,2,9,88,99
Venta_de_vehiculos_hibridos_y_electricos,2017,Octubre,Mexico,0,3,96,99
Venta_de_vehiculos_hibridos_y_electricos,2018,Febrero,No especificado,12,0,85,97
Venta_de_vehiculos_hibridos_y_electricos,2019,Junio,Oaxaca,0,1,95,96
Venta_de_vehiculos_hibridos_y_electricos,2016,Septiembre,Mexico,0,5,89,94
Venta_de_vehiculos_hibridos_y_electricos,2018,Agosto,Jalisco,1,2,91,94
Venta_de_vehiculos_hibridos_y_electricos,2017,Agosto,Mexico,1,4,87,92
Venta_de_vehiculos_hibridos_y_electricos,2019,Enero,Michoacan_de_Ocampo,2,4,84,90
Venta_de_vehiculos_hibridos_y_electricos,2019,Octubre,Michoacan_de_Ocampo,0,2,87,89
Venta_de_vehiculos_hibridos_y_electricos,2017,Enero,Mexico,2,5,81,88
Venta_de_vehiculos_hibridos_y_electricos,2019,Octubre,Queretaro_de_Arteaga,0,12,75,87
Venta_de_vehiculos_hibridos_y_electricos,2019,Octubre,Guanajuato,1,4,81,86
Venta_de_vehiculos_hibridos_y_electricos,2016,Noviembre,Nuevo_Leon,4,16,65,85
Venta_de_vehiculos_hibridos_y_electricos,2019,Julio,Nuevo_Leon,0,4,81,85
Venta_de_vehiculos_hibridos_y_electricos,2019,Agosto,Michoacan_de_Ocampo,0,3,81,84
Venta_de_vehiculos_hibridos_y_electricos,2018,Noviembre,Nuevo_Leon,1,8,74,83
Venta_de_vehiculos_hibridos_y_electricos,2017,Octubre,Jalisco,0,5,77,82
Venta_de_vehiculos_hibridos_y_electricos,2018,Julio,Jalisco,1,7,74,82
Venta_de_vehiculos_hibridos_y_electricos,2018,Enero,Jalisco,1,8,70,79
Venta_de_vehiculos_hibridos_y_electricos,2018,Septiembre,Nuevo_Leon,1,14,64,79
Venta_de_vehiculos_hibridos_y_electricos,2019,Enero,Guanajuato,6,8,65,79
Venta_de_vehiculos_hibridos_y_electricos,2019,Junio,Nuevo_Leon,0,4,75,79
Venta_de_vehiculos_hibridos_y_electricos,2019,Junio,Puebla,0,4,75,79
Venta_de_vehiculos_hibridos_y_electricos,2018,Enero,No especificado,4,0,74,78
Venta_de_vehiculos_hibridos_y_electricos,2019,Enero,Puebla,4,12,62,78
Venta_de_vehiculos_hibridos_y_electricos,2019,Mayo,Nuevo_Leon,0,8,70,78
Venta_de_vehiculos_hibridos_y_electricos,2019,Abril,Nuevo_Leon,3,5,69,77
Venta_de_vehiculos_hibridos_y_electricos,2019,Junio,Guanajuato,1,2,72,75
Venta_de_vehiculos_hibridos_y_electricos,2019,Julio,Michoacan_de_Ocampo,1,0,74,75
Venta_de_vehiculos_hibridos_y_electricos,2017,Diciembre,Michoacan_de_Ocampo,0,0,74,74
Venta_de_vehiculos_hibridos_y_electricos,2018,Junio,Nuevo_Leon,0,8,66,74
Venta_de_vehiculos_hibridos_y_electricos,2018,Noviembre,Queretaro_de_Arteaga,0,9,64,73
Venta_de_vehiculos_hibridos_y_electricos,2019,Enero,Nuevo_Leon,2,18,53,73
Venta_de_vehiculos_hibridos_y_electricos,2017,Septiembre,Nuevo_Leon,2,4,66,72
Venta_de_vehiculos_hibridos_y_electricos,2018,Junio,Michoacan_de_Ocampo,0,3,69,72
Venta_de_vehiculos_hibridos_y_electricos,2019,Febrero,Nuevo_Leon,2,8,62,72
Venta_de_vehiculos_hibridos_y_electricos,2019,Septiembre,Guanajuato,2,3,67,72
Venta_de_vehiculos_hibridos_y_electricos,2018,Noviembre,Guanajuato,1,4,65,70
Venta_de_vehiculos_hibridos_y_electricos,2019,Marzo,Queretaro_de_Arteaga,0,12,58,70
Venta_de_vehiculos_hibridos_y_electricos,2019,Octubre,Oaxaca,0,0,70,70
Venta_de_vehiculos_hibridos_y_electricos,2017,Marzo,Jalisco,1,7,61,69
Venta_de_vehiculos_hibridos_y_electricos,2019,Septiembre,Oaxaca,0,0,69,69
Venta_de_vehiculos_hibridos_y_electricos,2019,Octubre,Puebla,0,1,68,69
Venta_de_vehiculos_hibridos_y_electricos,2016,Junio,Nuevo_Leon,0,3,65,68
Venta_de_vehiculos_hibridos_y_electricos,2016,Julio,Jalisco,2,2,64,68
Venta_de_vehiculos_hibridos_y_electricos,2018,Agosto,Nuevo_Leon,0,3,65,68
Venta_de_vehiculos_hibridos_y_electricos,2018,Diciembre,Puebla,2,9,57,68
Venta_de_vehiculos_hibridos_y_electricos,2016,Enero,Ciudad_de_Mexico,4,0,63,67
Venta_de_vehiculos_hibridos_y_electricos,2017,Julio,Mexico,1,4,61,66
Venta_de_vehiculos_hibridos_y_electricos,2019,Septiembre,Puebla,0,3,63,66
Venta_de_vehiculos_hibridos_y_electricos,2016,Julio,Nuevo_Leon,3,1,61,65
Venta_de_vehiculos_hibridos_y_electricos,2016,Noviembre,Jalisco,8,6,51,65
Venta_de_vehiculos_hibridos_y_electricos,2018,Julio,Nuevo_Leon,2,4,59,65
Venta_de_vehiculos_hibridos_y_electricos,2019,Agosto,Puebla,0,5,60,65
Venta_de_vehiculos_hibridos_y_electricos,2018,Abril,No especificado,18,0,46,64
Venta_de_vehiculos_hibridos_y_electricos,2018,Noviembre,Puebla,0,4,59,63
Venta_de_vehiculos_hibridos_y_electricos,2019,Septiembre,Queretaro_de_Arteaga,1,5,57,63
Venta_de_vehiculos_hibridos_y_electricos,2016,Mayo,Jalisco,2,4,56,62
Venta_de_vehiculos_hibridos_y_electricos,2016,Diciembre,Jalisco,1,10,51,62
Venta_de_vehiculos_hibridos_y_electricos,2017,Noviembre,Jalisco,1,6,55,62
Venta_de_vehiculos_hibridos_y_electricos,2017,Diciembre,Nuevo_Leon,1,10,51,62
Venta_de_vehiculos_hibridos_y_electricos,2018,Octubre,Michoacan_de_Ocampo,0,0,62,62
Venta_de_vehiculos_hibridos_y_electricos,2018,Diciembre,Queretaro_de_Arteaga,0,5,57,62
Venta_de_vehiculos_hibridos_y_electricos,2016,Diciembre,Nuevo_Leon,0,11,50,61
Venta_de_vehiculos_hibridos_y_electricos,2019,Marzo,Morelos,4,10,47,61
Venta_de_vehiculos_hibridos_y_electricos,2016,Mayo,Puebla,0,1,59,60
Venta_de_vehiculos_hibridos_y_electricos,2016,Agosto,Nuevo_Leon,0,6,54,60
Venta_de_vehiculos_hibridos_y_electricos,2017,Abril,Jalisco,1,1,57,59
Venta_de_vehiculos_hibridos_y_electricos,2018,Mayo,Nuevo_Leon,3,16,40,59
Venta_de_vehiculos_hibridos_y_electricos,2019,Junio,Campeche,0,0,59,59
Venta_de_vehiculos_hibridos_y_electricos,2019,Junio,Queretaro_de_Arteaga,0,2,57,59
Venta_de_vehiculos_hibridos_y_electricos,2017,Septiembre,Jalisco,2,7,49,58
Venta_de_vehiculos_hibridos_y_electricos,2019,Marzo,Guanajuato,2,4,52,58
Venta_de_vehiculos_hibridos_y_electricos,2019,Agosto,Guanajuato,0,3,55,58
Venta_de_vehiculos_hibridos_y_electricos,2018,Mayo,Michoacan_de_Ocampo,0,5,52,57
Venta_de_vehiculos_hibridos_y_electricos,2018,Octubre,Nuevo_Leon,2,10,45,57
Venta_de_vehiculos_hibridos_y_electricos,2018,Abril,Michoacan_de_Ocampo,0,1,55,56
Venta_de_vehiculos_hibridos_y_electricos,2019,Octubre,Sinaloa,0,3,53,56
Venta_de_vehiculos_hibridos_y_electricos,2018,Mayo,No especificado,7,0,48,55
Venta_de_vehiculos_hibridos_y_electricos,2018,Julio,Queretaro_de_Arteaga,1,13,41,55
Venta_de_vehiculos_hibridos_y_electricos,2019,Febrero,Michoacan_de_Ocampo,0,1,54,55
Venta_de_vehiculos_hibridos_y_electricos,2017,Julio,Nuevo_Leon,0,7,47,54
Venta_de_vehiculos_hibridos_y_electricos,2017,Noviembre,Nuevo_Leon,1,8,45,54
Venta_de_vehiculos_hibridos_y_electricos,2019,Octubre,Morelos,0,6,48,54
Venta_de_vehiculos_hibridos_y_electricos,2016,Octubre,Jalisco,20,5,28,53
Venta_de_vehiculos_hibridos_y_electricos,2018,Febrero,Nuevo_Leon,0,8,45,53
Venta_de_vehiculos_hibridos_y_electricos,2018,Marzo,Nuevo_Leon,0,8,45,53
Venta_de_vehiculos_hibridos_y_electricos,2019,Enero,Queretaro_de_Arteaga,4,7,42,53
Venta_de_vehiculos_hibridos_y_electricos,2016,Agosto,Jalisco,1,8,43,52
Venta_de_vehiculos_hibridos_y_electricos,2018,Octubre,Guanajuato,0,0,52,52
Venta_de_vehiculos_hibridos_y_electricos,2019,Febrero,Puebla,1,13,38,52
Venta_de_vehiculos_hibridos_y_electricos,2019,Marzo,Puebla,0,2,50,52
Venta_de_vehiculos_hibridos_y_electricos,2016,Marzo,Mexico,3,0,48,51
Venta_de_vehiculos_hibridos_y_electricos,2018,Octubre,Puebla,1,1,49,51
Venta_de_vehiculos_hibridos_y_electricos,2019,Octubre,Baja_California,0,0,51,51
Venta_de_vehiculos_hibridos_y_electricos,2016,Octubre,Nuevo_Leon,3,6,41,50
Venta_de_vehiculos_hibridos_y_electricos,2017,Marzo,Nuevo_Leon,1,6,43,50
Venta_de_vehiculos_hibridos_y_electricos,2017,Julio,Jalisco,1,3,45,49
Venta_de_vehiculos_hibridos_y_electricos,2018,Marzo,Michoacan_de_Ocampo,0,7,42,49
Venta_de_vehiculos_hibridos_y_electricos,2018,Septiembre,Michoacan_de_Ocampo,0,1,48,49
Venta_de_vehiculos_hibridos_y_electricos,2018,Diciembre,Guanajuato,2,3,44,49
Venta_de_vehiculos_hibridos_y_electricos,2019,Febrero,Guanajuato,1,4,44,49
Venta_de_vehiculos_hibridos_y_electricos,2019,Julio,Guanajuato,0,1,48,49
Venta_de_vehiculos_hibridos_y_electricos,2019,Octubre,Veracruz_de_Ignacio_de_la_Llave,0,4,45,49
Venta_de_vehiculos_hibridos_y_electricos,2016,Marzo,Nuevo_Leon,3,3,42,48
Venta_de_vehiculos_hibridos_y_electricos,2018,Agosto,Puebla,1,0,47,48
Venta_de_vehiculos_hibridos_y_electricos,2018,Octubre,Chihuahua,2,0,46,48
Venta_de_vehiculos_hibridos_y_electricos,2019,Julio,Puebla,0,3,45,48
Venta_de_vehiculos_hibridos_y_electricos,2017,Junio,Jalisco,0,6,41,47
Venta_de_vehiculos_hibridos_y_electricos,2019,Febrero,Queretaro_de_Arteaga,2,8,37,47
Venta_de_vehiculos_hibridos_y_electricos,2019,Junio,Sinaloa,0,0,47,47
Venta_de_vehiculos_hibridos_y_electricos,2016,Mayo,Mexico,1,1,44,46
Venta_de_vehiculos_hibridos_y_electricos,2017,Junio,Nuevo_Leon,1,6,39,46
Venta_de_vehiculos_hibridos_y_electricos,2019,Julio,Queretaro_de_Arteaga,1,2,43,46
Venta_de_vehiculos_hibridos_y_electricos,2017,Agosto,Jalisco,3,5,37,45
Venta_de_vehiculos_hibridos_y_electricos,2018,Julio,Michoacan_de_Ocampo,0,2,43,45
Venta_de_vehiculos_hibridos_y_electricos,2017,Febrero,Nuevo_Leon,2,10,32,44
Venta_de_vehiculos_hibridos_y_electricos,2017,Mayo,Nuevo_Leon,2,9,33,44
Venta_de_vehiculos_hibridos_y_electricos,2017,Octubre,Nuevo_Leon,1,6,37,44
Venta_de_vehiculos_hibridos_y_electricos,2018,Enero,Nuevo_Leon,1,9,34,44
Venta_de_vehiculos_hibridos_y_electricos,2018,Abril,Nuevo_Leon,0,11,33,44
Venta_de_vehiculos_hibridos_y_electricos,2018,Septiembre,Puebla,0,4,40,44
Venta_de_vehiculos_hibridos_y_electricos,2019,Abril,Queretaro_de_Arteaga,2,7,35,44
Venta_de_vehiculos_hibridos_y_electricos,2019,Mayo,Guanajuato,0,3,41,44
Venta_de_vehiculos_hibridos_y_electricos,2016,Febrero,Ciudad_de_Mexico,7,0,36,43
Venta_de_vehiculos_hibridos_y_electricos,2016,Diciembre,Puebla,0,5,38,43
Venta_de_vehiculos_hibridos_y_electricos,2018,Septiembre,Guanajuato,0,4,39,43
Venta_de_vehiculos_hibridos_y_electricos,2018,Septiembre,Queretaro_de_Arteaga,0,7,36,43
Venta_de_vehiculos_hibridos_y_electricos,2019,Agosto,Sinaloa,0,1,42,43
Venta_de_vehiculos_hibridos_y_electricos,2019,Octubre,San_Luis_Potosi,0,3,40,43
Venta_de_vehiculos_hibridos_y_electricos,2017,Enero,Jalisco,15,6,21,42
Venta_de_vehiculos_hibridos_y_electricos,2017,Noviembre,Queretaro_de_Arteaga,2,3,37,42
Venta_de_vehiculos_hibridos_y_electricos,2018,Febrero,Queretaro_de_Arteaga,0,3,39,42
Venta_de_vehiculos_hibridos_y_electricos,2018,Mayo,Guanajuato,0,4,38,42
Venta_de_vehiculos_hibridos_y_electricos,2018,Octubre,Queretaro_de_Arteaga,0,5,37,42
Venta_de_vehiculos_hibridos_y_electricos,2016,Abril,Mexico,0,1,40,41
Venta_de_vehiculos_hibridos_y_electricos,2019,Enero,Oaxaca,0,0,41,41
Venta_de_vehiculos_hibridos_y_electricos,2019,Mayo,Puebla,1,3,37,41
Venta_de_vehiculos_hibridos_y_electricos,2019,Octubre,Hidalgo,0,2,39,41
Venta_de_vehiculos_hibridos_y_electricos,2016,Julio,Puebla,1,0,39,40
Venta_de_vehiculos_hibridos_y_electricos,2017,Diciembre,Coahuila_de_Zaragoza,0,1,39,40
Venta_de_vehiculos_hibridos_y_electricos,2017,Diciembre,Queretaro_de_Arteaga,0,3,37,40
Venta_de_vehiculos_hibridos_y_electricos,2018,Febrero,Puebla,0,4,36,40
Venta_de_vehiculos_hibridos_y_electricos,2018,Marzo,No especificado,10,0,30,40
Venta_de_vehiculos_hibridos_y_electricos,2019,Marzo,Oaxaca,0,0,40,40
Venta_de_vehiculos_hibridos_y_electricos,2019,Agosto,Queretaro_de_Arteaga,0,2,38,40
Venta_de_vehiculos_hibridos_y_electricos,2019,Septiembre,San_Luis_Potosi,0,2,38,40
Venta_de_vehiculos_hibridos_y_electricos,2019,Octubre,Coahuila_de_Zaragoza,0,1,39,40
Venta_de_vehiculos_hibridos_y_electricos,2016,Junio,Puebla,1,1,37,39
Venta_de_vehiculos_hibridos_y_electricos,2018,Febrero,Guanajuato,0,3,36,39
Venta_de_vehiculos_hibridos_y_electricos,2018,Mayo,Puebla,2,5,32,39
Venta_de_vehiculos_hibridos_y_electricos,2018,Junio,Morelos,0,5,34,39
Venta_de_vehiculos_hibridos_y_electricos,2018,Agosto,Oaxaca,0,0,39,39
Venta_de_vehiculos_hibridos_y_electricos,2018,Diciembre,Sinaloa,0,6,33,39
Venta_de_vehiculos_hibridos_y_electricos,2019,Junio,Veracruz_de_Ignacio_de_la_Llave,0,1,38,39
Venta_de_vehiculos_hibridos_y_electricos,2016,Septiembre,Jalisco,1,9,28,38
Venta_de_vehiculos_hibridos_y_electricos,2016,Noviembre,Tamaulipas,0,0,38,38
Venta_de_vehiculos_hibridos_y_electricos,2017,Julio,Michoacan_de_Ocampo,0,2,36,38
Venta_de_vehiculos_hibridos_y_electricos,2017,Diciembre,Guanajuato,0,6,32,38
Venta_de_vehiculos_hibridos_y_electricos,2019,Marzo,Veracruz_de_Ignacio_de_la_Llave,0,2,36,38
Venta_de_vehiculos_hibridos_y_electricos,2019,Septiembre,Morelos,0,5,33,38
Venta_de_vehiculos_hibridos_y_electricos,2018,Febrero,Michoacan_de_Ocampo,0,0,37,37
Venta_de_vehiculos_hibridos_y_electricos,2018,Mayo,Morelos,0,3,34,37
Venta_de_vehiculos_hibridos_y_electricos,2018,Agosto,Guanajuato,0,0,37,37
Venta_de_vehiculos_hibridos_y_electricos,2018,Diciembre,Morelos,0,3,34,37
Venta_de_vehiculos_hibridos_y_electricos,2019,Marzo,Baja_California,0,2,35,37
Venta_de_vehiculos_hibridos_y_electricos,2019,Octubre,Yucatan,1,6,30,37
Venta_de_vehiculos_hibridos_y_electricos,2017,Febrero,Jalisco,3,4,29,36
Venta_de_vehiculos_hibridos_y_electricos,2017,Marzo,Puebla,0,6,30,36
Venta_de_vehiculos_hibridos_y_electricos,2017,Abril,Nuevo_Leon,2,3,31,36
Venta_de_vehiculos_hibridos_y_electricos,2017,Septiembre,Coahuila_de_Zaragoza,0,1,35,36
Venta_de_vehiculos_hibridos_y_electricos,2018,Diciembre,Oaxaca,0,0,36,36
Venta_de_vehiculos_hibridos_y_electricos,2019,Agosto,Oaxaca,0,0,36,36
Venta_de_vehiculos_hibridos_y_electricos,2019,Septiembre,Veracruz_de_Ignacio_de_la_Llave,0,1,35,36
Venta_de_vehiculos_hibridos_y_electricos,2019,Marzo,Sinaloa,0,3,32,35
Venta_de_vehiculos_hibridos_y_electricos,2019,Abril,Michoacan_de_Ocampo,0,4,31,35
Venta_de_vehiculos_hibridos_y_electricos,2019,Junio,Morelos,0,1,34,35
Venta_de_vehiculos_hibridos_y_electricos,2019,Julio,Baja_California,0,1,34,35
Venta_de_vehiculos_hibridos_y_electricos,2016,Marzo,Jalisco,4,0,30,34
Venta_de_vehiculos_hibridos_y_electricos,2017,Octubre,Queretaro_de_Arteaga,0,5,29,34
Venta_de_vehiculos_hibridos_y_electricos,2018,Abril,Coahuila_de_Zaragoza,0,1,33,34
Venta_de_vehiculos_hibridos_y_electricos,2018,Abril,Veracruz_de_Ignacio_de_la_Llave,0,0,34,34
Venta_de_vehiculos_hibridos_y_electricos,2018,Noviembre,Morelos,0,4,30,34
Venta_de_vehiculos_hibridos_y_electricos,2018,Diciembre,Veracruz_de_Ignacio_de_la_Llave,0,1,33,34
Venta_de_vehiculos_hibridos_y_electricos,2019,Abril,Guanajuato,1,1,32,34
Venta_de_vehiculos_hibridos_y_electricos,2019,Septiembre,Baja_California,1,0,33,34
Venta_de_vehiculos_hibridos_y_electricos,2016,Abril,Jalisco,2,1,30,33
Venta_de_vehiculos_hibridos_y_electricos,2016,Septiembre,Nuevo_Leon,0,6,27,33
Venta_de_vehiculos_hibridos_y_electricos,2016,Diciembre,Guanajuato,0,3,30,33
Venta_de_vehiculos_hibridos_y_electricos,2017,Marzo,Michoacan_de_Ocampo,0,1,32,33
Venta_de_vehiculos_hibridos_y_electricos,2018,Enero,Michoacan_de_Ocampo,0,1,32,33
Venta_de_vehiculos_hibridos_y_electricos,2018,Marzo,Veracruz_de_Ignacio_de_la_Llave,0,1,32,33
Venta_de_vehiculos_hibridos_y_electricos,2018,Abril,Oaxaca,0,0,33,33
Venta_de_vehiculos_hibridos_y_electricos,2018,Junio,Queretaro_de_Arteaga,0,1,32,33
Venta_de_vehiculos_hibridos_y_electricos,2018,Agosto,Queretaro_de_Arteaga,2,0,31,33
Venta_de_vehiculos_hibridos_y_electricos,2019,Junio,Chihuahua,0,0,33,33
Venta_de_vehiculos_hibridos_y_electricos,2019,Junio,Durango,0,0,33,33
Venta_de_vehiculos_hibridos_y_electricos,2019,Septiembre,Sinaloa,1,2,30,33
Venta_de_vehiculos_hibridos_y_electricos,2016,Abril,Nuevo_Leon,0,7,25,32
Venta_de_vehiculos_hibridos_y_electricos,2018,Marzo,Queretaro_de_Arteaga,1,5,26,32
Venta_de_vehiculos_hibridos_y_electricos,2018,Mayo,Oaxaca,0,0,32,32
Venta_de_vehiculos_hibridos_y_electricos,2018,Julio,Guanajuato,1,1,30,32
Venta_de_vehiculos_hibridos_y_electricos,2018,Julio,Oaxaca,0,0,32,32
Venta_de_vehiculos_hibridos_y_electricos,2018,Agosto,Michoacan_de_Ocampo,0,2,30,32
Venta_de_vehiculos_hibridos_y_electricos,2018,Octubre,Oaxaca,0,0,32,32
Venta_de_vehiculos_hibridos_y_electricos,2018,Noviembre,Veracruz_de_Ignacio_de_la_Llave,0,1,31,32
Venta_de_vehiculos_hibridos_y_electricos,2019,Abril,Puebla,0,4,28,32
Venta_de_vehiculos_hibridos_y_electricos,2019,Abril,Veracruz_de_Ignacio_de_la_Llave,0,1,31,32
Venta_de_vehiculos_hibridos_y_electricos,2019,Julio,Morelos,0,3,29,32
Venta_de_vehiculos_hibridos_y_electricos,2017,Marzo,Oaxaca,0,0,31,31
Venta_de_vehiculos_hibridos_y_electricos,2018,Enero,Puebla,0,2,29,31
Venta_de_vehiculos_hibridos_y_electricos,2018,Febrero,Veracruz_de_Ignacio_de_la_Llave,0,2,29,31
Venta_de_vehiculos_hibridos_y_electricos,2018,Mayo,Veracruz_de_Ignacio_de_la_Llave,0,1,30,31
Venta_de_vehiculos_hibridos_y_electricos,2018,Julio,Morelos,1,5,25,31
Venta_de_vehiculos_hibridos_y_electricos,2018,Septiembre,Veracruz_de_Ignacio_de_la_Llave,0,0,31,31
Venta_de_vehiculos_hibridos_y_electricos,2018,Noviembre,Oaxaca,0,0,31,31
Venta_de_vehiculos_hibridos_y_electricos,2018,Diciembre,Coahuila_de_Zaragoza,0,1,30,31
Venta_de_vehiculos_hibridos_y_electricos,2019,Enero,Morelos,1,4,26,31
Venta_de_vehiculos_hibridos_y_electricos,2019,Enero,Sinaloa,0,3,28,31
Venta_de_vehiculos_hibridos_y_electricos,2019,Marzo,San_Luis_Potosi,0,3,28,31
Venta_de_vehiculos_hibridos_y_electricos,2019,Junio,Baja_California,0,0,31,31
Venta_de_vehiculos_hibridos_y_electricos,2019,Junio,San_Luis_Potosi,0,0,31,31
Venta_de_vehiculos_hibridos_y_electricos,2019,Julio,Oaxaca,0,0,31,31
Venta_de_vehiculos_hibridos_y_electricos,2019,Julio,Sinaloa,0,1,30,31
Venta_de_vehiculos_hibridos_y_electricos,2019,Julio,Veracruz_de_Ignacio_de_la_Llave,0,1,30,31
Venta_de_vehiculos_hibridos_y_electricos,2016,Febrero,Nuevo_Leon,0,2,28,30
Venta_de_vehiculos_hibridos_y_electricos,2017,Abril,Michoacan_de_Ocampo,0,0,30,30
Venta_de_vehiculos_hibridos_y_electricos,2017,Noviembre,Puebla,0,3,27,30
Venta_de_vehiculos_hibridos_y_electricos,2018,Febrero,Oaxaca,0,0,30,30
Venta_de_vehiculos_hibridos_y_electricos,2018,Junio,Guanajuato,0,4,26,30
Venta_de_vehiculos_hibridos_y_electricos,2018,Octubre,Morelos,0,3,27,30
Venta_de_vehiculos_hibridos_y_electricos,2018,Noviembre,Sinaloa,0,0,30,30
Venta_de_vehiculos_hibridos_y_electricos,2019,Enero,Coahuila_de_Zaragoza,0,2,28,30
Venta_de_vehiculos_hibridos_y_electricos,2019,Marzo,Chihuahua,0,1,29,30
Venta_de_vehiculos_hibridos_y_electricos,2019,Marzo,Hidalgo,0,1,29,30
Venta_de_vehiculos_hibridos_y_electricos,2017,Mayo,Michoacan_de_Ocampo,0,0,29,29
Venta_de_vehiculos_hibridos_y_electricos,2017,Diciembre,Puebla,1,2,26,29
Venta_de_vehiculos_hibridos_y_electricos,2018,Abril,Guanajuato,0,5,24,29
Venta_de_vehiculos_hibridos_y_electricos,2018,Junio,Veracruz_de_Ignacio_de_la_Llave,0,0,29,29
Venta_de_vehiculos_hibridos_y_electricos,2018,Octubre,Hidalgo,0,1,28,29
Venta_de_vehiculos_hibridos_y_electricos,2018,Noviembre,Coahuila_de_Zaragoza,0,3,26,29
Venta_de_vehiculos_hibridos_y_electricos,2019,Marzo,Yucatan,0,1,28,29
Venta_de_vehiculos_hibridos_y_electricos,2019,Junio,Coahuila_de_Zaragoza,0,1,28,29
Venta_de_vehiculos_hibridos_y_electricos,2019,Julio,Yucatan,0,1,28,29
Venta_de_vehiculos_hibridos_y_electricos,2019,Agosto,Morelos,0,2,27,29
Venta_de_vehiculos_hibridos_y_electricos,2016,Marzo,Puebla,1,0,27,28
Venta_de_vehiculos_hibridos_y_electricos,2016,Diciembre,Tamaulipas,0,0,28,28
Venta_de_vehiculos_hibridos_y_electricos,2017,Octubre,Michoacan_de_Ocampo,0,0,28,28
Venta_de_vehiculos_hibridos_y_electricos,2018,Enero,Guanajuato,0,4,24,28
Venta_de_vehiculos_hibridos_y_electricos,2018,Abril,Puebla,0,6,22,28
Venta_de_vehiculos_hibridos_y_electricos,2018,Agosto,Veracruz_de_Ignacio_de_la_Llave,0,0,28,28
Venta_de_vehiculos_hibridos_y_electricos,2019,Marzo,Sonora,0,1,27,28
Venta_de_vehiculos_hibridos_y_electricos,2019,Mayo,Queretaro_de_Arteaga,1,0,27,28
Venta_de_vehiculos_hibridos_y_electricos,2019,Junio,Sonora,0,0,28,28
Venta_de_vehiculos_hibridos_y_electricos,2019,Agosto,Veracruz_de_Ignacio_de_la_Llave,0,0,28,28
Venta_de_vehiculos_hibridos_y_electricos,2019,Septiembre,Sonora,0,1,27,28
Venta_de_vehiculos_hibridos_y_electricos,2019,Octubre,Chihuahua,0,1,27,28
Venta_de_vehiculos_hibridos_y_electricos,2019,Octubre,Sonora,0,1,27,28
Venta_de_vehiculos_hibridos_y_electricos,2016,Junio,Guanajuato,0,1,26,27
Venta_de_vehiculos_hibridos_y_electricos,2018,Marzo,Morelos,0,9,18,27
Venta_de_vehiculos_hibridos_y_electricos,2018,Marzo,Puebla,0,0,27,27
Venta_de_vehiculos_hibridos_y_electricos,2018,Agosto,Yucatan,0,0,27,27
Venta_de_vehiculos_hibridos_y_electricos,2018,Septiembre,Morelos,0,7,20,27
Venta_de_vehiculos_hibridos_y_electricos,2018,Septiembre,Sinaloa,0,0,27,27
Venta_de_vehiculos_hibridos_y_electricos,2018,Diciembre,Hidalgo,0,2,25,27
Venta_de_vehiculos_hibridos_y_electricos,2019,Abril,Morelos,0,8,19,27
Venta_de_vehiculos_hibridos_y_electricos,2019,Septiembre,Coahuila_de_Zaragoza,0,1,26,27
Venta_de_vehiculos_hibridos_y_electricos,2019,Septiembre,Yucatan,0,2,25,27
Venta_de_vehiculos_hibridos_y_electricos,2016,Junio,Veracruz_de_Ignacio_de_la_Llave,0,0,26,26
Venta_de_vehiculos_hibridos_y_electricos,2016,Agosto,Queretaro_de_Arteaga,0,1,25,26
Venta_de_vehiculos_hibridos_y_electricos,2017,Marzo,Guanajuato,3,4,19,26
Venta_de_vehiculos_hibridos_y_electricos,2017,Abril,Puebla,2,0,24,26
Venta_de_vehiculos_hibridos_y_electricos,2017,Agosto,Morelos,1,2,23,26
Venta_de_vehiculos_hibridos_y_electricos,2017,Septiembre,Michoacan_de_Ocampo,0,0,26,26
Venta_de_vehiculos_hibridos_y_electricos,2018,Mayo,Coahuila_de_Zaragoza,0,2,24,26
Venta_de_vehiculos_hibridos_y_electricos,2018,Mayo,Queretaro_de_Arteaga,0,6,20,26
Venta_de_vehiculos_hibridos_y_electricos,2018,Junio,Oaxaca,0,0,26,26
Venta_de_vehiculos_hibridos_y_electricos,2018,Junio,San_Luis_Potosi,0,3,23,26
Venta_de_vehiculos_hibridos_y_electricos,2018,Junio,Sinaloa,0,6,20,26
Venta_de_vehiculos_hibridos_y_electricos,2018,Septiembre,Baja_California,0,2,24,26
Venta_de_vehiculos_hibridos_y_electricos,2018,Septiembre,Oaxaca,0,0,26,26
Venta_de_vehiculos_hibridos_y_electricos,2019,Febrero,Baja_California,0,1,25,26
Venta_de_vehiculos_hibridos_y_electricos,2019,Marzo,Coahuila_de_Zaragoza,0,1,25,26
Venta_de_vehiculos_hibridos_y_electricos,2019,Agosto,Baja_California,0,1,25,26
Venta_de_vehiculos_hibridos_y_electricos,2016,Julio,Queretaro_de_Arteaga,0,0,25,25
Venta_de_vehiculos_hibridos_y_electricos,2016,Agosto,Veracruz_de_Ignacio_de_la_Llave,0,1,24,25
Venta_de_vehiculos_hibridos_y_electricos,2017,Marzo,Queretaro_de_Arteaga,1,0,24,25
Venta_de_vehiculos_hibridos_y_electricos,2017,Abril,Queretaro_de_Arteaga,1,2,22,25
Venta_de_vehiculos_hibridos_y_electricos,2018,Enero,Queretaro_de_Arteaga,0,1,24,25
Venta_de_vehiculos_hibridos_y_electricos,2018,Enero,Veracruz_de_Ignacio_de_la_Llave,0,2,23,25
Venta_de_vehiculos_hibridos_y_electricos,2018,Octubre,San_Luis_Potosi,0,2,23,25
Venta_de_vehiculos_hibridos_y_electricos,2018,Octubre,Veracruz_de_Ignacio_de_la_Llave,0,0,25,25
Venta_de_vehiculos_hibridos_y_electricos,2018,Diciembre,Baja_California,1,1,23,25
Venta_de_vehiculos_hibridos_y_electricos,2019,Enero,Hidalgo,0,1,24,25
Venta_de_vehiculos_hibridos_y_electricos,2019,Febrero,Morelos,0,11,14,25
Venta_de_vehiculos_hibridos_y_electricos,2019,Febrero,Veracruz_de_Ignacio_de_la_Llave,0,2,23,25
Venta_de_vehiculos_hibridos_y_electricos,2019,Mayo,Oaxaca,0,0,25,25
Venta_de_vehiculos_hibridos_y_electricos,2019,Mayo,Sinaloa,1,0,24,25
Venta_de_vehiculos_hibridos_y_electricos,2019,Julio,Coahuila_de_Zaragoza,0,2,23,25
Venta_de_vehiculos_hibridos_y_electricos,2019,Octubre,Aguascalientes,0,1,24,25
Venta_de_vehiculos_hibridos_y_electricos,2016,Septiembre,Puebla,0,4,20,24
Venta_de_vehiculos_hibridos_y_electricos,2017,Abril,Oaxaca,0,0,24,24
Venta_de_vehiculos_hibridos_y_electricos,2018,Marzo,Guanajuato,0,2,22,24
Venta_de_vehiculos_hibridos_y_electricos,2018,Abril,Queretaro_de_Arteaga,0,7,17,24
Venta_de_vehiculos_hibridos_y_electricos,2018,Julio,Puebla,0,4,20,24
Venta_de_vehiculos_hibridos_y_electricos,2018,Septiembre,San_Luis_Potosi,0,2,22,24
Venta_de_vehiculos_hibridos_y_electricos,2018,Septiembre,Yucatan,0,1,23,24
Venta_de_vehiculos_hibridos_y_electricos,2019,Enero,Veracruz_de_Ignacio_de_la_Llave,0,1,23,24
Venta_de_vehiculos_hibridos_y_electricos,2019,Febrero,Oaxaca,1,0,23,24
Venta_de_vehiculos_hibridos_y_electricos,2019,Julio,Hidalgo,1,2,21,24
Venta_de_vehiculos_hibridos_y_electricos,2019,Septiembre,Chihuahua,0,0,24,24
Venta_de_vehiculos_hibridos_y_electricos,2016,Marzo,Veracruz_de_Ignacio_de_la_Llave,3,0,20,23
Venta_de_vehiculos_hibridos_y_electricos,2016,Mayo,Nuevo_Leon,1,2,20,23
Venta_de_vehiculos_hibridos_y_electricos,2017,Enero,Nuevo_Leon,1,6,16,23
Venta_de_vehiculos_hibridos_y_electricos,2017,Febrero,Puebla,1,4,18,23
Venta_de_vehiculos_hibridos_y_electricos,2017,Mayo,Veracruz_de_Ignacio_de_la_Llave,0,0,23,23
Venta_de_vehiculos_hibridos_y_electricos,2017,Octubre,Puebla,0,4,19,23
Venta_de_vehiculos_hibridos_y_electricos,2018,Febrero,Morelos,0,4,19,23
Venta_de_vehiculos_hibridos_y_electricos,2018,Abril,Morelos,0,3,20,23
Venta_de_vehiculos_hibridos_y_electricos,2018,Junio,Yucatan,0,3,20,23
Venta_de_vehiculos_hibridos_y_electricos,2018,Agosto,Sinaloa,0,0,23,23
Venta_de_vehiculos_hibridos_y_electricos,2018,Noviembre,San_Luis_Potosi,0,2,21,23
Venta_de_vehiculos_hibridos_y_electricos,2018,Diciembre,Chihuahua,0,0,23,23
Venta_de_vehiculos_hibridos_y_electricos,2019,Mayo,Hidalgo,1,0,22,23
Venta_de_vehiculos_hibridos_y_electricos,2016,Junio,San_Luis_Potosi,0,0,22,22
Venta_de_vehiculos_hibridos_y_electricos,2017,Julio,Oaxaca,0,0,22,22
Venta_de_vehiculos_hibridos_y_electricos,2017,Agosto,Michoacan_de_Ocampo,1,0,21,22
Venta_de_vehiculos_hibridos_y_electricos,2017,Diciembre,Morelos,0,3,19,22
Venta_de_vehiculos_hibridos_y_electricos,2018,Abril,Hidalgo,0,0,22,22
Venta_de_vehiculos_hibridos_y_electricos,2018,Noviembre,Sonora,0,0,22,22
Venta_de_vehiculos_hibridos_y_electricos,2019,Enero,Baja_California,0,3,19,22
Venta_de_vehiculos_hibridos_y_electricos,2019,Abril,Oaxaca,0,0,22,22
Venta_de_vehiculos_hibridos_y_electricos,2019,Mayo,Michoacan_de_Ocampo,0,0,22,22
Venta_de_vehiculos_hibridos_y_electricos,2019,Octubre,Quintana Roo,0,1,21,22
Venta_de_vehiculos_hibridos_y_electricos,2016,Agosto,Guanajuato,0,0,21,21
Venta_de_vehiculos_hibridos_y_electricos,2016,Diciembre,Queretaro_de_Arteaga,0,1,20,21
Venta_de_vehiculos_hibridos_y_electricos,2017,Noviembre,Michoacan_de_Ocampo,0,0,21,21
Venta_de_vehiculos_hibridos_y_electricos,2018,Febrero,San_Luis_Potosi,0,4,17,21
Venta_de_vehiculos_hibridos_y_electricos,2018,Septiembre,Hidalgo,0,0,21,21
Venta_de_vehiculos_hibridos_y_electricos,2018,Octubre,Sinaloa,0,1,20,21
Venta_de_vehiculos_hibridos_y_electricos,2018,Noviembre,Hidalgo,0,3,18,21
Venta_de_vehiculos_hibridos_y_electricos,2019,Enero,Chihuahua,0,0,21,21
Venta_de_vehiculos_hibridos_y_electricos,2019,Septiembre,Hidalgo,0,1,20,21
Venta_de_vehiculos_hibridos_y_electricos,2016,Julio,Veracruz_de_Ignacio_de_la_Llave,0,0,20,20
Venta_de_vehiculos_hibridos_y_electricos,2016,Septiembre,Guanajuato,1,2,17,20
Venta_de_vehiculos_hibridos_y_electricos,2016,Octubre,Queretaro_de_Arteaga,0,1,19,20
Venta_de_vehiculos_hibridos_y_electricos,2017,Enero,Puebla,0,3,17,20
Venta_de_vehiculos_hibridos_y_electricos,2017,Abril,Guanajuato,0,2,18,20
Venta_de_vehiculos_hibridos_y_electricos,2017,Junio,Puebla,0,2,18,20
Venta_de_vehiculos_hibridos_y_electricos,2017,Julio,Puebla,0,3,17,20
Venta_de_vehiculos_hibridos_y_electricos,2017,Agosto,Queretaro_de_Arteaga,1,4,15,20
Venta_de_vehiculos_hibridos_y_electricos,2017,Octubre,Guanajuato,1,0,19,20
Venta_de_vehiculos_hibridos_y_electricos,2017,Diciembre,Veracruz_de_Ignacio_de_la_Llave,0,0,20,20
Venta_de_vehiculos_hibridos_y_electricos,2018,Febrero,Sinaloa,0,0,20,20
Venta_de_vehiculos_hibridos_y_electricos,2018,Marzo,San_Luis_Potosi,0,0,20,20
Venta_de_vehiculos_hibridos_y_electricos,2018,Abril,Yucatan,0,5,15,20
Venta_de_vehiculos_hibridos_y_electricos,2018,Julio,Baja_California,0,3,17,20
Venta_de_vehiculos_hibridos_y_electricos,2018,Julio,Veracruz_de_Ignacio_de_la_Llave,0,0,20,20
Venta_de_vehiculos_hibridos_y_electricos,2018,Septiembre,Coahuila_de_Zaragoza,1,1,18,20
Venta_de_vehiculos_hibridos_y_electricos,2018,Noviembre,Baja_California,2,5,13,20
Venta_de_vehiculos_hibridos_y_electricos,2018,Diciembre,San_Luis_Potosi,0,0,20,20
Venta_de_vehiculos_hibridos_y_electricos,2019,Agosto,San_Luis_Potosi,0,1,19,20
Venta_de_vehiculos_hibridos_y_electricos,2019,Octubre,Tamaulipas,0,0,20,20
Venta_de_vehiculos_hibridos_y_electricos,2016,Septiembre,Queretaro_de_Arteaga,0,3,16,19
Venta_de_vehiculos_hibridos_y_electricos,2016,Septiembre,Quintana Roo,0,0,19,19
Venta_de_vehiculos_hibridos_y_electricos,2016,Noviembre,Queretaro_de_Arteaga,0,2,17,19
Venta_de_vehiculos_hibridos_y_electricos,2016,Noviembre,Veracruz_de_Ignacio_de_la_Llave,0,1,18,19
Venta_de_vehiculos_hibridos_y_electricos,2016,Diciembre,Sinaloa,0,0,19,19
Venta_de_vehiculos_hibridos_y_electricos,2017,Febrero,Michoacan_de_Ocampo,0,2,17,19
Venta_de_vehiculos_hibridos_y_electricos,2017,Febrero,Sinaloa,1,0,18,19
Venta_de_vehiculos_hibridos_y_electricos,2017,Marzo,Morelos,0,3,16,19
Venta_de_vehiculos_hibridos_y_electricos,2017,Marzo,Veracruz_de_Ignacio_de_la_Llave,0,0,19,19
Venta_de_vehiculos_hibridos_y_electricos,2017,Mayo,Queretaro_de_Arteaga,0,3,16,19
Venta_de_vehiculos_hibridos_y_electricos,2017,Julio,Morelos,0,4,15,19
Venta_de_vehiculos_hibridos_y_electricos,2017,Agosto,Guanajuato,1,1,17,19
Venta_de_vehiculos_hibridos_y_electricos,2017,Noviembre,Guanajuato,0,4,15,19
Venta_de_vehiculos_hibridos_y_electricos,2017,Noviembre,Veracruz_de_Ignacio_de_la_Llave,0,1,18,19
Venta_de_vehiculos_hibridos_y_electricos,2018,Febrero,Tamaulipas,0,0,19,19
Venta_de_vehiculos_hibridos_y_electricos,2018,Marzo,Coahuila_de_Zaragoza,0,0,19,19
Venta_de_vehiculos_hibridos_y_electricos,2018,Marzo,Sinaloa,0,0,19,19
Venta_de_vehiculos_hibridos_y_electricos,2018,Junio,Sonora,0,7,12,19
Venta_de_vehiculos_hibridos_y_electricos,2018,Julio,Sinaloa,0,1,18,19
Venta_de_vehiculos_hibridos_y_electricos,2018,Agosto,Sonora,0,0,19,19
Venta_de_vehiculos_hibridos_y_electricos,2018,Noviembre,Chihuahua,0,1,18,19
Venta_de_vehiculos_hibridos_y_electricos,2018,Diciembre,Yucatan,1,0,18,19
Venta_de_vehiculos_hibridos_y_electricos,2019,Marzo,Quintana Roo,0,1,18,19
Venta_de_vehiculos_hibridos_y_electricos,2019,Abril,Baja_California,0,0,19,19
Venta_de_vehiculos_hibridos_y_electricos,2019,Junio,Tabasco,0,0,19,19
Venta_de_vehiculos_hibridos_y_electricos,2019,Agosto,Hidalgo,0,1,18,19
Venta_de_vehiculos_hibridos_y_electricos,2019,Septiembre,Tamaulipas,0,1,18,19
Venta_de_vehiculos_hibridos_y_electricos,2016,Noviembre,Puebla,0,4,14,18
Venta_de_vehiculos_hibridos_y_electricos,2017,Marzo,Sinaloa,0,0,18,18
Venta_de_vehiculos_hibridos_y_electricos,2017,Abril,Veracruz_de_Ignacio_de_la_Llave,0,0,18,18
Venta_de_vehiculos_hibridos_y_electricos,2017,Noviembre,Morelos,0,6,12,18
Venta_de_vehiculos_hibridos_y_electricos,2018,Mayo,Quintana Roo,0,4,14,18
Venta_de_vehiculos_hibridos_y_electricos,2018,Mayo,Sinaloa,0,1,17,18
Venta_de_vehiculos_hibridos_y_electricos,2018,Octubre,Sonora,0,0,18,18
Venta_de_vehiculos_hibridos_y_electricos,2018,Diciembre,Quintana Roo,1,1,16,18
Venta_de_vehiculos_hibridos_y_electricos,2019,Febrero,Quintana Roo,0,2,16,18
Venta_de_vehiculos_hibridos_y_electricos,2019,Mayo,Chihuahua,0,0,18,18
Venta_de_vehiculos_hibridos_y_electricos,2019,Junio,Tamaulipas,0,0,18,18
Venta_de_vehiculos_hibridos_y_electricos,2019,Junio,Yucatan,0,0,18,18
Venta_de_vehiculos_hibridos_y_electricos,2019,Septiembre,Aguascalientes,0,0,18,18
Venta_de_vehiculos_hibridos_y_electricos,2016,Enero,Mexico,1,1,15,17
Venta_de_vehiculos_hibridos_y_electricos,2016,Junio,Aguascalientes,0,0,17,17
Venta_de_vehiculos_hibridos_y_electricos,2016,Agosto,Morelos,0,0,17,17
Venta_de_vehiculos_hibridos_y_electricos,2016,Octubre,Veracruz_de_Ignacio_de_la_Llave,0,0,17,17
Venta_de_vehiculos_hibridos_y_electricos,2016,Diciembre,Coahuila_de_Zaragoza,0,1,16,17
Venta_de_vehiculos_hibridos_y_electricos,2017,Enero,Queretaro_de_Arteaga,0,2,15,17
Venta_de_vehiculos_hibridos_y_electricos,2017,Abril,Morelos,0,4,13,17
Venta_de_vehiculos_hibridos_y_electricos,2017,Julio,Guanajuato,1,0,16,17
Venta_de_vehiculos_hibridos_y_electricos,2017,Octubre,Morelos,0,4,13,17
Venta_de_vehiculos_hibridos_y_electricos,2017,Diciembre,Sinaloa,0,0,17,17
Venta_de_vehiculos_hibridos_y_electricos,2018,Enero,Oaxaca,0,0,17,17
Venta_de_vehiculos_hibridos_y_electricos,2018,Febrero,Yucatan,0,5,12,17
Venta_de_vehiculos_hibridos_y_electricos,2018,Marzo,Yucatan,0,3,14,17
Venta_de_vehiculos_hibridos_y_electricos,2018,Junio,Puebla,0,3,14,17
Venta_de_vehiculos_hibridos_y_electricos,2018,Agosto,Baja_California,0,0,17,17
Venta_de_vehiculos_hibridos_y_electricos,2018,Agosto,Hidalgo,0,0,17,17
Venta_de_vehiculos_hibridos_y_electricos,2018,Octubre,Aguascalientes,2,0,15,17
Venta_de_vehiculos_hibridos_y_electricos,2019,Enero,Aguascalientes,0,0,17,17
Venta_de_vehiculos_hibridos_y_electricos,2019,Febrero,Aguascalientes,0,0,17,17
Venta_de_vehiculos_hibridos_y_electricos,2019,Febrero,Chihuahua,0,0,17,17
Venta_de_vehiculos_hibridos_y_electricos,2019,Abril,Hidalgo,0,0,17,17
Venta_de_vehiculos_hibridos_y_electricos,2019,Julio,San_Luis_Potosi,0,0,17,17
Venta_de_vehiculos_hibridos_y_electricos,2019,Julio,Sonora,0,2,15,17
Venta_de_vehiculos_hibridos_y_electricos,2019,Agosto,Coahuila_de_Zaragoza,0,2,15,17
Venta_de_vehiculos_hibridos_y_electricos,2016,Marzo,Guanajuato,2,0,14,16
Venta_de_vehiculos_hibridos_y_electricos,2016,Agosto,Puebla,0,1,15,16
Venta_de_vehiculos_hibridos_y_electricos,2016,Octubre,Puebla,0,2,14,16
Venta_de_vehiculos_hibridos_y_electricos,2016,Diciembre,Veracruz_de_Ignacio_de_la_Llave,0,0,16,16
Venta_de_vehiculos_hibridos_y_electricos,2017,Febrero,Oaxaca,0,0,16,16
Venta_de_vehiculos_hibridos_y_electricos,2017,Febrero,Queretaro_de_Arteaga,1,3,12,16
Venta_de_vehiculos_hibridos_y_electricos,2017,Febrero,Veracruz_de_Ignacio_de_la_Llave,0,1,15,16
Venta_de_vehiculos_hibridos_y_electricos,2017,Marzo,San_Luis_Potosi,1,0,15,16
Venta_de_vehiculos_hibridos_y_electricos,2017,Mayo,Oaxaca,0,0,16,16
Venta_de_vehiculos_hibridos_y_electricos,2017,Julio,Queretaro_de_Arteaga,0,1,15,16
Venta_de_vehiculos_hibridos_y_electricos,2017,Agosto,Coahuila_de_Zaragoza,0,0,16,16
Venta_de_vehiculos_hibridos_y_electricos,2017,Noviembre,Hidalgo,0,0,16,16
Venta_de_vehiculos_hibridos_y_electricos,2017,Diciembre,Hidalgo,0,0,16,16
Venta_de_vehiculos_hibridos_y_electricos,2018,Enero,Coahuila_de_Zaragoza,0,2,14,16
Venta_de_vehiculos_hibridos_y_electricos,2018,Marzo,Baja_California,0,0,16,16
Venta_de_vehiculos_hibridos_y_electricos,2018,Marzo,Oaxaca,0,1,15,16
Venta_de_vehiculos_hibridos_y_electricos,2018,Abril,Sonora,0,6,10,16
Venta_de_vehiculos_hibridos_y_electricos,2018,Mayo,Baja_California,0,2,14,16
Venta_de_vehiculos_hibridos_y_electricos,2018,Mayo,Sonora,0,1,15,16
Venta_de_vehiculos_hibridos_y_electricos,2018,Junio,Coahuila_de_Zaragoza,0,5,11,16
Venta_de_vehiculos_hibridos_y_electricos,2018,Julio,Chihuahua,0,0,16,16
Venta_de_vehiculos_hibridos_y_electricos,2018,Septiembre,Aguascalientes,0,0,16,16
Venta_de_vehiculos_hibridos_y_electricos,2018,Septiembre,Quintana Roo,0,3,13,16
Venta_de_vehiculos_hibridos_y_electricos,2018,Septiembre,Tamaulipas,0,0,16,16
Venta_de_vehiculos_hibridos_y_electricos,2018,Octubre,Coahuila_de_Zaragoza,0,0,16,16
Venta_de_vehiculos_hibridos_y_electricos,2018,Octubre,Yucatan,0,4,12,16
Venta_de_vehiculos_hibridos_y_electricos,2018,Diciembre,Sonora,1,1,14,16
Venta_de_vehiculos_hibridos_y_electricos,2019,Enero,San_Luis_Potosi,0,0,16,16
Venta_de_vehiculos_hibridos_y_electricos,2019,Enero,Sonora,0,2,14,16
Venta_de_vehiculos_hibridos_y_electricos,2019,Enero,Yucatan,0,3,13,16
Venta_de_vehiculos_hibridos_y_electricos,2019,Febrero,Sonora,0,1,15,16
Venta_de_vehiculos_hibridos_y_electricos,2019,Febrero,Tabasco,0,0,16,16
Venta_de_vehiculos_hibridos_y_electricos,2019,Abril,Chihuahua,0,0,16,16
Venta_de_vehiculos_hibridos_y_electricos,2019,Abril,Sinaloa,1,0,15,16
Venta_de_vehiculos_hibridos_y_electricos,2019,Junio,Aguascalientes,0,0,16,16
Venta_de_vehiculos_hibridos_y_electricos,2019,Junio,Hidalgo,0,0,16,16
Venta_de_vehiculos_hibridos_y_electricos,2019,Agosto,Aguascalientes,0,0,16,16
Venta_de_vehiculos_hibridos_y_electricos,2019,Octubre,Baja_California Sur,0,1,15,16
Venta_de_vehiculos_hibridos_y_electricos,2019,Octubre,Colima,0,0,16,16
Venta_de_vehiculos_hibridos_y_electricos,2016,Enero,Nuevo_Leon,2,3,10,15
Venta_de_vehiculos_hibridos_y_electricos,2016,Julio,Guanajuato,0,0,15,15
Venta_de_vehiculos_hibridos_y_electricos,2016,Agosto,Hidalgo,0,0,15,15
Venta_de_vehiculos_hibridos_y_electricos,2016,Diciembre,Morelos,0,6,9,15
Venta_de_vehiculos_hibridos_y_electricos,2017,Febrero,Guanajuato,0,2,13,15
Venta_de_vehiculos_hibridos_y_electricos,2017,Febrero,Morelos,1,4,10,15
Venta_de_vehiculos_hibridos_y_electricos,2017,Julio,Sinaloa,0,0,15,15
Venta_de_vehiculos_hibridos_y_electricos,2017,Septiembre,Queretaro_de_Arteaga,0,2,13,15
Venta_de_vehiculos_hibridos_y_electricos,2017,Octubre,Quintana Roo,0,1,14,15
Venta_de_vehiculos_hibridos_y_electricos,2017,Diciembre,Baja_California,0,0,15,15
Venta_de_vehiculos_hibridos_y_electricos,2017,Diciembre,Sonora,0,2,13,15
Venta_de_vehiculos_hibridos_y_electricos,2017,Diciembre,Tamaulipas,0,0,15,15
Venta_de_vehiculos_hibridos_y_electricos,2018,Enero,Hidalgo,0,0,15,15
Venta_de_vehiculos_hibridos_y_electricos,2018,Abril,Quintana Roo,0,5,10,15
Venta_de_vehiculos_hibridos_y_electricos,2018,Abril,San_Luis_Potosi,0,3,12,15
Venta_de_vehiculos_hibridos_y_electricos,2018,Abril,Sinaloa,0,1,14,15
Venta_de_vehiculos_hibridos_y_electricos,2018,Mayo,Hidalgo,0,0,15,15
Venta_de_vehiculos_hibridos_y_electricos,2018,Mayo,San_Luis_Potosi,0,2,13,15
Venta_de_vehiculos_hibridos_y_electricos,2018,Agosto,San_Luis_Potosi,0,0,15,15
Venta_de_vehiculos_hibridos_y_electricos,2019,Enero,Quintana Roo,1,2,12,15
Venta_de_vehiculos_hibridos_y_electricos,2019,Febrero,Sinaloa,0,0,15,15
Venta_de_vehiculos_hibridos_y_electricos,2019,Junio,Quintana Roo,0,1,14,15
Venta_de_vehiculos_hibridos_y_electricos,2019,Agosto,Tamaulipas,1,0,14,15
Venta_de_vehiculos_hibridos_y_electricos,2019,Octubre,Guerrero,0,0,15,15
Venta_de_vehiculos_hibridos_y_electricos,2016,Marzo,Chihuahua,0,0,14,14
Venta_de_vehiculos_hibridos_y_electricos,2016,Marzo,Queretaro_de_Arteaga,0,0,14,14
Venta_de_vehiculos_hibridos_y_electricos,2016,Julio,Coahuila_de_Zaragoza,0,0,14,14
Venta_de_vehiculos_hibridos_y_electricos,2016,Octubre,Hidalgo,0,0,14,14
Venta_de_vehiculos_hibridos_y_electricos,2016,Noviembre,Guanajuato,0,0,14,14
Venta_de_vehiculos_hibridos_y_electricos,2016,Diciembre,Quintana Roo,0,3,11,14
Venta_de_vehiculos_hibridos_y_electricos,2017,Enero,Guanajuato,0,1,13,14
Venta_de_vehiculos_hibridos_y_electricos,2017,Enero,Sinaloa,0,0,14,14
Venta_de_vehiculos_hibridos_y_electricos,2017,Marzo,Colima,0,0,14,14
Venta_de_vehiculos_hibridos_y_electricos,2017,Abril,Sinaloa,1,0,13,14
Venta_de_vehiculos_hibridos_y_electricos,2017,Mayo,Puebla,0,1,13,14
Venta_de_vehiculos_hibridos_y_electricos,2017,Junio,Coahuila_de_Zaragoza,0,1,13,14
Venta_de_vehiculos_hibridos_y_electricos,2017,Junio,Guanajuato,0,0,14,14
Venta_de_vehiculos_hibridos_y_electricos,2017,Septiembre,Guanajuato,0,2,12,14
Venta_de_vehiculos_hibridos_y_electricos,2017,Septiembre,Veracruz_de_Ignacio_de_la_Llave,0,0,14,14
Venta_de_vehiculos_hibridos_y_electricos,2017,Diciembre,Chihuahua,0,0,14,14
Venta_de_vehiculos_hibridos_y_electricos,2018,Enero,Morelos,0,1,13,14
Venta_de_vehiculos_hibridos_y_electricos,2018,Enero,Quintana Roo,0,3,11,14
Venta_de_vehiculos_hibridos_y_electricos,2018,Febrero,Coahuila_de_Zaragoza,0,0,14,14
Venta_de_vehiculos_hibridos_y_electricos,2018,Abril,Tamaulipas,0,0,14,14
Venta_de_vehiculos_hibridos_y_electricos,2018,Mayo,Chihuahua,0,0,14,14
Venta_de_vehiculos_hibridos_y_electricos,2018,Junio,Tamaulipas,0,0,14,14
Venta_de_vehiculos_hibridos_y_electricos,2018,Julio,Quintana Roo,0,2,12,14
Venta_de_vehiculos_hibridos_y_electricos,2018,Julio,San_Luis_Potosi,0,1,13,14
Venta_de_vehiculos_hibridos_y_electricos,2018,Octubre,Baja_California,0,0,14,14
Venta_de_vehiculos_hibridos_y_electricos,2018,Noviembre,Aguascalientes,0,0,14,14
Venta_de_vehiculos_hibridos_y_electricos,2018,Noviembre,Tamaulipas,0,0,14,14
Venta_de_vehiculos_hibridos_y_electricos,2018,Diciembre,Aguascalientes,0,0,14,14
Venta_de_vehiculos_hibridos_y_electricos,2019,Enero,Tamaulipas,0,0,14,14
Venta_de_vehiculos_hibridos_y_electricos,2019,Febrero,San_Luis_Potosi,0,2,12,14
Venta_de_vehiculos_hibridos_y_electricos,2019,Julio,Chihuahua,0,1,13,14
Venta_de_vehiculos_hibridos_y_electricos,2019,Agosto,Chihuahua,0,1,13,14
Venta_de_vehiculos_hibridos_y_electricos,2019,Agosto,Yucatan,0,0,14,14
Venta_de_vehiculos_hibridos_y_electricos,2019,Septiembre,Quintana Roo,0,0,14,14
Venta_de_vehiculos_hibridos_y_electricos,2016,Mayo,San_Luis_Potosi,0,0,13,13
Venta_de_vehiculos_hibridos_y_electricos,2016,Junio,Coahuila_de_Zaragoza,0,0,13,13
Venta_de_vehiculos_hibridos_y_electricos,2016,Junio,Queretaro_de_Arteaga,2,0,11,13
Venta_de_vehiculos_hibridos_y_electricos,2016,Agosto,Coahuila_de_Zaragoza,0,0,13,13
Venta_de_vehiculos_hibridos_y_electricos,2016,Agosto,Sinaloa,0,0,13,13
Venta_de_vehiculos_hibridos_y_electricos,2016,Octubre,Guanajuato,0,3,10,13
Venta_de_vehiculos_hibridos_y_electricos,2016,Diciembre,Chihuahua,0,0,13,13
Venta_de_vehiculos_hibridos_y_electricos,2016,Diciembre,Hidalgo,0,0,13,13
Venta_de_vehiculos_hibridos_y_electricos,2016,Diciembre,San_Luis_Potosi,0,1,12,13
Venta_de_vehiculos_hibridos_y_electricos,2017,Enero,Morelos,0,4,9,13
Venta_de_vehiculos_hibridos_y_electricos,2017,Abril,Chihuahua,0,0,13,13
Venta_de_vehiculos_hibridos_y_electricos,2017,Junio,Morelos,0,3,10,13
Venta_de_vehiculos_hibridos_y_electricos,2017,Junio,Queretaro_de_Arteaga,0,4,9,13
Venta_de_vehiculos_hibridos_y_electricos,2017,Julio,Veracruz_de_Ignacio_de_la_Llave,0,0,13,13
Venta_de_vehiculos_hibridos_y_electricos,2017,Octubre,Sinaloa,0,0,13,13
Venta_de_vehiculos_hibridos_y_electricos,2018,Marzo,Tamaulipas,0,0,13,13
Venta_de_vehiculos_hibridos_y_electricos,2018,Junio,Hidalgo,0,0,13,13
Venta_de_vehiculos_hibridos_y_electricos,2018,Julio,Aguascalientes,0,0,13,13
Venta_de_vehiculos_hibridos_y_electricos,2018,Agosto,Morelos,0,0,13,13
Venta_de_vehiculos_hibridos_y_electricos,2019,Enero,Tabasco,0,0,13,13
Venta_de_vehiculos_hibridos_y_electricos,2019,Febrero,Yucatan,0,0,13,13
Venta_de_vehiculos_hibridos_y_electricos,2019,Marzo,Colima,0,0,13,13
Venta_de_vehiculos_hibridos_y_electricos,2019,Marzo,Tamaulipas,0,0,13,13
Venta_de_vehiculos_hibridos_y_electricos,2019,Abril,Aguascalientes,0,0,13,13
Venta_de_vehiculos_hibridos_y_electricos,2019,Junio,Baja_California Sur,0,0,13,13
Venta_de_vehiculos_hibridos_y_electricos,2019,Julio,Quintana Roo,0,1,12,13
Venta_de_vehiculos_hibridos_y_electricos,2019,Septiembre,Colima,0,1,12,13
Venta_de_vehiculos_hibridos_y_electricos,2019,Septiembre,Tabasco,0,0,13,13
Venta_de_vehiculos_hibridos_y_electricos,2016,Abril,Hidalgo,0,0,12,12
Venta_de_vehiculos_hibridos_y_electricos,2016,Abril,Veracruz_de_Ignacio_de_la_Llave,0,1,11,12
Venta_de_vehiculos_hibridos_y_electricos,2016,Junio,Morelos,0,0,12,12
Venta_de_vehiculos_hibridos_y_electricos,2016,Junio,Sinaloa,0,0,12,12
Venta_de_vehiculos_hibridos_y_electricos,2016,Septiembre,Morelos,0,1,11,12
Venta_de_vehiculos_hibridos_y_electricos,2016,Septiembre,Veracruz_de_Ignacio_de_la_Llave,0,0,12,12
Venta_de_vehiculos_hibridos_y_electricos,2016,Diciembre,Yucatan,2,1,9,12
Venta_de_vehiculos_hibridos_y_electricos,2017,Enero,Oaxaca,0,0,12,12
Venta_de_vehiculos_hibridos_y_electricos,2017,Febrero,San_Luis_Potosi,0,0,12,12
Venta_de_vehiculos_hibridos_y_electricos,2017,Marzo,Hidalgo,0,0,12,12
Venta_de_vehiculos_hibridos_y_electricos,2017,Mayo,Guanajuato,1,0,11,12
Venta_de_vehiculos_hibridos_y_electricos,2017,Junio,Veracruz_de_Ignacio_de_la_Llave,0,1,11,12
Venta_de_vehiculos_hibridos_y_electricos,2017,Agosto,Puebla,1,3,8,12
Venta_de_vehiculos_hibridos_y_electricos,2017,Septiembre,Baja_California,0,0,12,12
Venta_de_vehiculos_hibridos_y_electricos,2017,Septiembre,Puebla,0,1,11,12
Venta_de_vehiculos_hibridos_y_electricos,2018,Enero,Baja_California,0,0,12,12
Venta_de_vehiculos_hibridos_y_electricos,2018,Enero,Chihuahua,0,0,12,12
Venta_de_vehiculos_hibridos_y_electricos,2018,Enero,Yucatan,0,2,10,12
Venta_de_vehiculos_hibridos_y_electricos,2018,Febrero,Aguascalientes,0,0,12,12
Venta_de_vehiculos_hibridos_y_electricos,2018,Marzo,Chihuahua,0,0,12,12
Venta_de_vehiculos_hibridos_y_electricos,2018,Junio,Chihuahua,0,3,9,12
Venta_de_vehiculos_hibridos_y_electricos,2018,Julio,Sonora,0,1,11,12
Venta_de_vehiculos_hibridos_y_electricos,2018,Agosto,Coahuila_de_Zaragoza,0,0,12,12
Venta_de_vehiculos_hibridos_y_electricos,2018,Agosto,Tamaulipas,0,0,12,12
Venta_de_vehiculos_hibridos_y_electricos,2018,Septiembre,Chihuahua,0,0,12,12
Venta_de_vehiculos_hibridos_y_electricos,2018,Diciembre,Colima,0,0,12,12
Venta_de_vehiculos_hibridos_y_electricos,2019,Febrero,Coahuila_de_Zaragoza,0,3,9,12
Venta_de_vehiculos_hibridos_y_electricos,2019,Febrero,Tamaulipas,0,0,12,12
Venta_de_vehiculos_hibridos_y_electricos,2019,Abril,Coahuila_de_Zaragoza,0,0,12,12
Venta_de_vehiculos_hibridos_y_electricos,2019,Mayo,Morelos,0,1,11,12
Venta_de_vehiculos_hibridos_y_electricos,2019,Mayo,San_Luis_Potosi,0,1,11,12
Venta_de_vehiculos_hibridos_y_electricos,2019,Julio,Tamaulipas,0,2,10,12
Venta_de_vehiculos_hibridos_y_electricos,2016,Febrero,Jalisco,5,0,6,11
Venta_de_vehiculos_hibridos_y_electricos,2016,Marzo,Aguascalientes,1,0,10,11
Venta_de_vehiculos_hibridos_y_electricos,2016,Marzo,Sinaloa,2,0,9,11
Venta_de_vehiculos_hibridos_y_electricos,2016,Abril,Guanajuato,0,0,11,11
Venta_de_vehiculos_hibridos_y_electricos,2016,Abril,Queretaro_de_Arteaga,1,0,10,11
Venta_de_vehiculos_hibridos_y_electricos,2016,Julio,Aguascalientes,0,0,11,11
Venta_de_vehiculos_hibridos_y_electricos,2016,Julio,Hidalgo,0,0,11,11
Venta_de_vehiculos_hibridos_y_electricos,2016,Septiembre,Sinaloa,0,0,11,11
Venta_de_vehiculos_hibridos_y_electricos,2016,Noviembre,Coahuila_de_Zaragoza,0,1,10,11
Venta_de_vehiculos_hibridos_y_electricos,2016,Noviembre,San_Luis_Potosi,0,3,8,11
Venta_de_vehiculos_hibridos_y_electricos,2017,Febrero,Coahuila_de_Zaragoza,1,0,10,11
Venta_de_vehiculos_hibridos_y_electricos,2017,Marzo,Chihuahua,0,0,11,11
Venta_de_vehiculos_hibridos_y_electricos,2017,Marzo,Sonora,0,0,11,11
Venta_de_vehiculos_hibridos_y_electricos,2017,Abril,San_Luis_Potosi,0,1,10,11
Venta_de_vehiculos_hibridos_y_electricos,2017,Junio,Sinaloa,0,0,11,11
Venta_de_vehiculos_hibridos_y_electricos,2017,Agosto,Veracruz_de_Ignacio_de_la_Llave,0,0,11,11
Venta_de_vehiculos_hibridos_y_electricos,2017,Agosto,Yucatan,0,0,11,11
Venta_de_vehiculos_hibridos_y_electricos,2017,Octubre,Veracruz_de_Ignacio_de_la_Llave,0,0,11,11
Venta_de_vehiculos_hibridos_y_electricos,2017,Noviembre,Coahuila_de_Zaragoza,0,1,10,11
Venta_de_vehiculos_hibridos_y_electricos,2017,Diciembre,Oaxaca,0,0,11,11
Venta_de_vehiculos_hibridos_y_electricos,2017,Diciembre,San_Luis_Potosi,1,1,9,11
Venta_de_vehiculos_hibridos_y_electricos,2018,Enero,Tamaulipas,0,0,11,11
Venta_de_vehiculos_hibridos_y_electricos,2018,Marzo,Hidalgo,0,0,11,11
Venta_de_vehiculos_hibridos_y_electricos,2018,Marzo,Tlaxcala,0,0,11,11
Venta_de_vehiculos_hibridos_y_electricos,2018,Abril,Baja_California,0,1,10,11
Venta_de_vehiculos_hibridos_y_electricos,2018,Mayo,Tamaulipas,0,0,11,11
Venta_de_vehiculos_hibridos_y_electricos,2018,Junio,Baja_California,0,3,8,11
Venta_de_vehiculos_hibridos_y_electricos,2018,Junio,Quintana Roo,0,2,9,11
Venta_de_vehiculos_hibridos_y_electricos,2018,Julio,Tamaulipas,0,0,11,11
Venta_de_vehiculos_hibridos_y_electricos,2018,Agosto,Chihuahua,0,0,11,11
Venta_de_vehiculos_hibridos_y_electricos,2018,Octubre,Quintana Roo,0,0,11,11
Venta_de_vehiculos_hibridos_y_electricos,2018,Diciembre,Tabasco,0,0,11,11
Venta_de_vehiculos_hibridos_y_electricos,2018,Diciembre,Tamaulipas,0,0,11,11
Venta_de_vehiculos_hibridos_y_electricos,2019,Marzo,Aguascalientes,0,0,11,11
Venta_de_vehiculos_hibridos_y_electricos,2019,Abril,Baja_California Sur,0,0,11,11
Venta_de_vehiculos_hibridos_y_electricos,2019,Julio,Aguascalientes,0,0,11,11
Venta_de_vehiculos_hibridos_y_electricos,2019,Agosto,Sonora,0,0,11,11
Venta_de_vehiculos_hibridos_y_electricos,2016,Julio,San_Luis_Potosi,0,0,10,10
Venta_de_vehiculos_hibridos_y_electricos,2016,Noviembre,Morelos,0,3,7,10
Venta_de_vehiculos_hibridos_y_electricos,2016,Diciembre,Baja_California,0,0,10,10
Venta_de_vehiculos_hibridos_y_electricos,2016,Diciembre,Sonora,0,0,10,10
Venta_de_vehiculos_hibridos_y_electricos,2017,Enero,Veracruz_de_Ignacio_de_la_Llave,0,0,10,10
Venta_de_vehiculos_hibridos_y_electricos,2017,Febrero,Baja_California,1,0,9,10
Venta_de_vehiculos_hibridos_y_electricos,2017,Marzo,Coahuila_de_Zaragoza,0,0,10,10
Venta_de_vehiculos_hibridos_y_electricos,2017,Marzo,Yucatan,0,0,10,10
Venta_de_vehiculos_hibridos_y_electricos,2017,Mayo,Coahuila_de_Zaragoza,0,0,10,10
Venta_de_vehiculos_hibridos_y_electricos,2017,Mayo,Yucatan,0,0,10,10
Venta_de_vehiculos_hibridos_y_electricos,2017,Septiembre,Oaxaca,0,0,10,10
Venta_de_vehiculos_hibridos_y_electricos,2017,Octubre,Oaxaca,0,0,10,10
Venta_de_vehiculos_hibridos_y_electricos,2017,Octubre,Tamaulipas,0,0,10,10
Venta_de_vehiculos_hibridos_y_electricos,2017,Noviembre,Oaxaca,0,0,10,10
Venta_de_vehiculos_hibridos_y_electricos,2017,Noviembre,Sinaloa,1,0,9,10
Venta_de_vehiculos_hibridos_y_electricos,2018,Febrero,Chihuahua,0,0,10,10
Venta_de_vehiculos_hibridos_y_electricos,2018,Febrero,Sonora,0,1,9,10
Venta_de_vehiculos_hibridos_y_electricos,2018,Abril,Chihuahua,0,0,10,10
Venta_de_vehiculos_hibridos_y_electricos,2018,Julio,Hidalgo,0,1,9,10
Venta_de_vehiculos_hibridos_y_electricos,2018,Julio,Yucatan,0,2,8,10
Venta_de_vehiculos_hibridos_y_electricos,2018,Agosto,Tabasco,0,1,9,10
Venta_de_vehiculos_hibridos_y_electricos,2018,Septiembre,Sonora,1,0,9,10
Venta_de_vehiculos_hibridos_y_electricos,2018,Septiembre,Tabasco,0,0,10,10
Venta_de_vehiculos_hibridos_y_electricos,2018,Septiembre,Tlaxcala,0,0,10,10
Venta_de_vehiculos_hibridos_y_electricos,2018,Noviembre,Colima,0,0,10,10
Venta_de_vehiculos_hibridos_y_electricos,2018,Noviembre,Quintana Roo,0,0,10,10
Venta_de_vehiculos_hibridos_y_electricos,2018,Noviembre,Yucatan,0,2,8,10
Venta_de_vehiculos_hibridos_y_electricos,2018,Diciembre,Baja_California Sur,0,0,10,10
Venta_de_vehiculos_hibridos_y_electricos,2019,Febrero,Hidalgo,0,2,8,10
Venta_de_vehiculos_hibridos_y_electricos,2019,Marzo,Baja_California Sur,0,0,10,10
Venta_de_vehiculos_hibridos_y_electricos,2019,Abril,San_Luis_Potosi,0,0,10,10
Venta_de_vehiculos_hibridos_y_electricos,2019,Abril,Tamaulipas,0,0,10,10
Venta_de_vehiculos_hibridos_y_electricos,2019,Junio,Zacatecas,0,0,10,10
Venta_de_vehiculos_hibridos_y_electricos,2019,Julio,Colima,0,0,10,10
Venta_de_vehiculos_hibridos_y_electricos,2019,Octubre,Zacatecas,0,0,10,10
Venta_de_vehiculos_hibridos_y_electricos,2016,Enero,Jalisco,2,0,7,9
Venta_de_vehiculos_hibridos_y_electricos,2016,Marzo,Baja_California,2,0,7,9
Venta_de_vehiculos_hibridos_y_electricos,2016,Abril,Puebla,0,2,7,9
Venta_de_vehiculos_hibridos_y_electricos,2016,Junio,Chihuahua,0,0,9,9
Venta_de_vehiculos_hibridos_y_electricos,2016,Junio,Durango,0,0,9,9
Venta_de_vehiculos_hibridos_y_electricos,2016,Julio,Sinaloa,0,0,9,9
Venta_de_vehiculos_hibridos_y_electricos,2016,Julio,Sonora,0,0,9,9
Venta_de_vehiculos_hibridos_y_electricos,2016,Septiembre,Hidalgo,0,0,9,9
Venta_de_vehiculos_hibridos_y_electricos,2016,Noviembre,Sonora,0,0,9,9
Venta_de_vehiculos_hibridos_y_electricos,2017,Enero,Baja_California,0,0,9,9
Venta_de_vehiculos_hibridos_y_electricos,2017,Enero,Coahuila_de_Zaragoza,0,0,9,9
Venta_de_vehiculos_hibridos_y_electricos,2017,Enero,Michoacan_de_Ocampo,0,1,8,9
Venta_de_vehiculos_hibridos_y_electricos,2017,Febrero,Chihuahua,0,0,9,9
Venta_de_vehiculos_hibridos_y_electricos,2017,Febrero,Quintana Roo,0,3,6,9
Venta_de_vehiculos_hibridos_y_electricos,2017,Marzo,Tamaulipas,0,0,9,9
Venta_de_vehiculos_hibridos_y_electricos,2017,Abril,Baja_California,0,0,9,9
Venta_de_vehiculos_hibridos_y_electricos,2017,Mayo,Morelos,0,3,6,9
Venta_de_vehiculos_hibridos_y_electricos,2017,Mayo,Sinaloa,0,0,9,9
Venta_de_vehiculos_hibridos_y_electricos,2017,Junio,Chihuahua,0,0,9,9
Venta_de_vehiculos_hibridos_y_electricos,2017,Junio,Quintana Roo,0,1,8,9
Venta_de_vehiculos_hibridos_y_electricos,2017,Agosto,Aguascalientes,0,0,9,9
Venta_de_vehiculos_hibridos_y_electricos,2017,Agosto,Baja_California,1,0,8,9
Venta_de_vehiculos_hibridos_y_electricos,2017,Septiembre,Morelos,0,0,9,9
Venta_de_vehiculos_hibridos_y_electricos,2017,Octubre,Yucatan,0,0,9,9
Venta_de_vehiculos_hibridos_y_electricos,2017,Diciembre,Quintana Roo,0,2,7,9
Venta_de_vehiculos_hibridos_y_electricos,2018,Enero,San_Luis_Potosi,0,2,7,9
Venta_de_vehiculos_hibridos_y_electricos,2018,Febrero,Baja_California,0,0,9,9
Venta_de_vehiculos_hibridos_y_electricos,2018,Febrero,Colima,0,0,9,9
Venta_de_vehiculos_hibridos_y_electricos,2018,Marzo,Aguascalientes,0,0,9,9
Venta_de_vehiculos_hibridos_y_electricos,2018,Abril,Aguascalientes,0,0,9,9
Venta_de_vehiculos_hibridos_y_electricos,2018,Junio,Aguascalientes,0,0,9,9
Venta_de_vehiculos_hibridos_y_electricos,2018,Septiembre,Colima,0,0,9,9
Venta_de_vehiculos_hibridos_y_electricos,2018,Noviembre,Tabasco,0,0,9,9
Venta_de_vehiculos_hibridos_y_electricos,2019,Enero,Colima,0,0,9,9
Venta_de_vehiculos_hibridos_y_electricos,2019,Marzo,Chiapas,0,0,9,9
Venta_de_vehiculos_hibridos_y_electricos,2019,Marzo,Zacatecas,0,0,9,9
Venta_de_vehiculos_hibridos_y_electricos,2019,Abril,Quintana Roo,0,2,7,9
Venta_de_vehiculos_hibridos_y_electricos,2019,Mayo,Quintana Roo,0,1,8,9
Venta_de_vehiculos_hibridos_y_electricos,2019,Mayo,Tabasco,0,0,9,9
Venta_de_vehiculos_hibridos_y_electricos,2019,Mayo,Tamaulipas,0,0,9,9
Venta_de_vehiculos_hibridos_y_electricos,2019,Mayo,Veracruz_de_Ignacio_de_la_Llave,0,0,9,9
Venta_de_vehiculos_hibridos_y_electricos,2019,Mayo,Yucatan,0,0,9,9
Venta_de_vehiculos_hibridos_y_electricos,2019,Junio,Colima,0,0,9,9
Venta_de_vehiculos_hibridos_y_electricos,2019,Junio,Guerrero,0,0,9,9
Venta_de_vehiculos_hibridos_y_electricos,2019,Julio,Tabasco,0,0,9,9
Venta_de_vehiculos_hibridos_y_electricos,2019,Agosto,Quintana Roo,0,2,7,9
Venta_de_vehiculos_hibridos_y_electricos,2019,Agosto,Tlaxcala,0,0,9,9
Venta_de_vehiculos_hibridos_y_electricos,2019,Octubre,Chiapas,0,0,9,9
Venta_de_vehiculos_hibridos_y_electricos,2016,Marzo,Coahuila_de_Zaragoza,2,0,6,8
Venta_de_vehiculos_hibridos_y_electricos,2016,Marzo,Tamaulipas,3,0,5,8
Venta_de_vehiculos_hibridos_y_electricos,2016,Mayo,Guanajuato,0,1,7,8
Venta_de_vehiculos_hibridos_y_electricos,2016,Junio,Tlaxcala,0,0,8,8
Venta_de_vehiculos_hibridos_y_electricos,2016,Julio,Morelos,0,0,8,8
Venta_de_vehiculos_hibridos_y_electricos,2016,Agosto,Baja_California,0,0,8,8
Venta_de_vehiculos_hibridos_y_electricos,2016,Agosto,San_Luis_Potosi,0,0,8,8
Venta_de_vehiculos_hibridos_y_electricos,2016,Septiembre,Baja_California,1,0,7,8
Venta_de_vehiculos_hibridos_y_electricos,2016,Septiembre,Chihuahua,0,0,8,8
Venta_de_vehiculos_hibridos_y_electricos,2016,Noviembre,Hidalgo,0,0,8,8
Venta_de_vehiculos_hibridos_y_electricos,2016,Noviembre,Sinaloa,0,0,8,8
Venta_de_vehiculos_hibridos_y_electricos,2016,Diciembre,Oaxaca,0,0,8,8
Venta_de_vehiculos_hibridos_y_electricos,2017,Enero,San_Luis_Potosi,0,3,5,8
Venta_de_vehiculos_hibridos_y_electricos,2017,Febrero,Sonora,0,1,7,8
Venta_de_vehiculos_hibridos_y_electricos,2017,Marzo,Chiapas,0,0,8,8
Venta_de_vehiculos_hibridos_y_electricos,2017,Abril,Yucatan,0,0,8,8
Venta_de_vehiculos_hibridos_y_electricos,2017,Junio,Hidalgo,0,0,8,8
Venta_de_vehiculos_hibridos_y_electricos,2017,Junio,Michoacan_de_Ocampo,0,0,8,8
Venta_de_vehiculos_hibridos_y_electricos,2017,Junio,Oaxaca,0,0,8,8
Venta_de_vehiculos_hibridos_y_electricos,2017,Junio,San_Luis_Potosi,0,3,5,8
Venta_de_vehiculos_hibridos_y_electricos,2017,Junio,Sonora,0,1,7,8
Venta_de_vehiculos_hibridos_y_electricos,2017,Julio,Coahuila_de_Zaragoza,0,0,8,8
Venta_de_vehiculos_hibridos_y_electricos,2017,Julio,San_Luis_Potosi,0,0,8,8
Venta_de_vehiculos_hibridos_y_electricos,2017,Septiembre,Sinaloa,2,0,6,8
Venta_de_vehiculos_hibridos_y_electricos,2017,Septiembre,Tamaulipas,1,0,7,8
Venta_de_vehiculos_hibridos_y_electricos,2017,Noviembre,Baja_California,0,0,8,8
Venta_de_vehiculos_hibridos_y_electricos,2017,Noviembre,Yucatan,0,1,7,8
Venta_de_vehiculos_hibridos_y_electricos,2017,Diciembre,Yucatan,0,2,6,8
Venta_de_vehiculos_hibridos_y_electricos,2018,Enero,Sinaloa,0,0,8,8
Venta_de_vehiculos_hibridos_y_electricos,2018,Enero,Tlaxcala,0,0,8,8
Venta_de_vehiculos_hibridos_y_electricos,2018,Febrero,Hidalgo,0,0,8,8
Venta_de_vehiculos_hibridos_y_electricos,2018,Marzo,Colima,0,0,8,8
Venta_de_vehiculos_hibridos_y_electricos,2018,Mayo,Campeche,0,0,8,8
Venta_de_vehiculos_hibridos_y_electricos,2018,Mayo,Yucatan,0,1,7,8
Venta_de_vehiculos_hibridos_y_electricos,2018,Julio,Colima,0,0,8,8
Venta_de_vehiculos_hibridos_y_electricos,2018,Agosto,Colima,0,0,8,8
Venta_de_vehiculos_hibridos_y_electricos,2018,Agosto,Quintana Roo,0,0,8,8
Venta_de_vehiculos_hibridos_y_electricos,2018,Octubre,Baja_California Sur,0,0,8,8
Venta_de_vehiculos_hibridos_y_electricos,2018,Noviembre,Durango,0,0,8,8
Venta_de_vehiculos_hibridos_y_electricos,2018,Noviembre,Guerrero,0,0,8,8
Venta_de_vehiculos_hibridos_y_electricos,2018,Noviembre,Tlaxcala,0,0,8,8
Venta_de_vehiculos_hibridos_y_electricos,2019,Febrero,Colima,0,0,8,8
Venta_de_vehiculos_hibridos_y_electricos,2019,Marzo,Tabasco,0,1,7,8
Venta_de_vehiculos_hibridos_y_electricos,2019,Mayo,Coahuila_de_Zaragoza,0,2,6,8
Venta_de_vehiculos_hibridos_y_electricos,2019,Junio,Chiapas,0,0,8,8
Venta_de_vehiculos_hibridos_y_electricos,2019,Julio,Baja_California Sur,0,0,8,8
Venta_de_vehiculos_hibridos_y_electricos,2019,Septiembre,Chiapas,0,0,8,8
Venta_de_vehiculos_hibridos_y_electricos,2019,Septiembre,Tlaxcala,0,0,8,8
Venta_de_vehiculos_hibridos_y_electricos,2019,Octubre,Durango,0,0,8,8
Venta_de_vehiculos_hibridos_y_electricos,2019,Octubre,Tlaxcala,0,0,8,8
Venta_de_vehiculos_hibridos_y_electricos,2016,Marzo,Durango,1,0,6,7
Venta_de_vehiculos_hibridos_y_electricos,2016,Marzo,Hidalgo,2,0,5,7
Venta_de_vehiculos_hibridos_y_electricos,2016,Marzo,Yucatan,0,1,6,7
Venta_de_vehiculos_hibridos_y_electricos,2016,Abril,Coahuila_de_Zaragoza,0,1,6,7
Venta_de_vehiculos_hibridos_y_electricos,2016,Abril,Morelos,1,0,6,7
Venta_de_vehiculos_hibridos_y_electricos,2016,Junio,Hidalgo,0,0,7,7
Venta_de_vehiculos_hibridos_y_electricos,2016,Junio,Michoacan_de_Ocampo,1,0,6,7
Venta_de_vehiculos_hibridos_y_electricos,2016,Junio,Tamaulipas,0,0,7,7
Venta_de_vehiculos_hibridos_y_electricos,2016,Julio,Colima,0,0,7,7
Venta_de_vehiculos_hibridos_y_electricos,2016,Julio,Durango,0,0,7,7
Venta_de_vehiculos_hibridos_y_electricos,2016,Agosto,Chihuahua,0,0,7,7
Venta_de_vehiculos_hibridos_y_electricos,2016,Agosto,Yucatan,0,0,7,7
Venta_de_vehiculos_hibridos_y_electricos,2016,Septiembre,Aguascalientes,0,0,7,7
Venta_de_vehiculos_hibridos_y_electricos,2016,Octubre,Chihuahua,0,0,7,7
Venta_de_vehiculos_hibridos_y_electricos,2016,Octubre,Sinaloa,0,0,7,7
Venta_de_vehiculos_hibridos_y_electricos,2016,Octubre,Tamaulipas,0,0,7,7
Venta_de_vehiculos_hibridos_y_electricos,2017,Enero,Durango,0,0,7,7
Venta_de_vehiculos_hibridos_y_electricos,2017,Febrero,Yucatan,0,0,7,7
Venta_de_vehiculos_hibridos_y_electricos,2017,Marzo,Quintana Roo,0,0,7,7
Venta_de_vehiculos_hibridos_y_electricos,2017,Abril,Hidalgo,0,0,7,7
Venta_de_vehiculos_hibridos_y_electricos,2017,Abril,Quintana Roo,0,3,4,7
Venta_de_vehiculos_hibridos_y_electricos,2017,Abril,Sonora,0,0,7,7
Venta_de_vehiculos_hibridos_y_electricos,2017,Mayo,Aguascalientes,0,0,7,7
Venta_de_vehiculos_hibridos_y_electricos,2017,Mayo,Hidalgo,0,0,7,7
Venta_de_vehiculos_hibridos_y_electricos,2017,Julio,Sonora,0,0,7,7
Venta_de_vehiculos_hibridos_y_electricos,2017,Julio,Tamaulipas,0,0,7,7
Venta_de_vehiculos_hibridos_y_electricos,2017,Agosto,Hidalgo,1,0,6,7
Venta_de_vehiculos_hibridos_y_electricos,2017,Agosto,Oaxaca,0,0,7,7
Venta_de_vehiculos_hibridos_y_electricos,2017,Agosto,Sinaloa,0,0,7,7
Venta_de_vehiculos_hibridos_y_electricos,2017,Septiembre,Chihuahua,0,0,7,7
Venta_de_vehiculos_hibridos_y_electricos,2017,Septiembre,Quintana Roo,0,1,6,7
Venta_de_vehiculos_hibridos_y_electricos,2017,Octubre,Baja_California,0,0,7,7
Venta_de_vehiculos_hibridos_y_electricos,2017,Octubre,San_Luis_Potosi,1,1,5,7
Venta_de_vehiculos_hibridos_y_electricos,2017,Noviembre,Aguascalientes,0,0,7,7
Venta_de_vehiculos_hibridos_y_electricos,2017,Noviembre,Quintana Roo,0,2,5,7
Venta_de_vehiculos_hibridos_y_electricos,2018,Enero,Colima,0,0,7,7
Venta_de_vehiculos_hibridos_y_electricos,2018,Enero,Tabasco,0,0,7,7
Venta_de_vehiculos_hibridos_y_electricos,2018,Febrero,Quintana Roo,0,1,6,7
Venta_de_vehiculos_hibridos_y_electricos,2018,Marzo,Guerrero,0,0,7,7
Venta_de_vehiculos_hibridos_y_electricos,2018,Marzo,Zacatecas,0,0,7,7
Venta_de_vehiculos_hibridos_y_electricos,2018,Abril,Colima,0,0,7,7
Venta_de_vehiculos_hibridos_y_electricos,2018,Mayo,Baja_California Sur,0,0,7,7
Venta_de_vehiculos_hibridos_y_electricos,2018,Junio,Colima,0,0,7,7
Venta_de_vehiculos_hibridos_y_electricos,2018,Julio,Coahuila_de_Zaragoza,0,1,6,7
Venta_de_vehiculos_hibridos_y_electricos,2018,Julio,Chiapas,0,0,7,7
Venta_de_vehiculos_hibridos_y_electricos,2018,Septiembre,Durango,0,0,7,7
Venta_de_vehiculos_hibridos_y_electricos,2018,Octubre,Colima,0,0,7,7
Venta_de_vehiculos_hibridos_y_electricos,2018,Octubre,Guerrero,0,0,7,7
Venta_de_vehiculos_hibridos_y_electricos,2018,Octubre,Tamaulipas,0,0,7,7
Venta_de_vehiculos_hibridos_y_electricos,2018,Octubre,Tlaxcala,0,0,7,7
Venta_de_vehiculos_hibridos_y_electricos,2018,Noviembre,Baja_California Sur,0,0,7,7
Venta_de_vehiculos_hibridos_y_electricos,2018,Noviembre,Zacatecas,0,0,7,7
Venta_de_vehiculos_hibridos_y_electricos,2019,Enero,Baja_California Sur,0,0,7,7
Venta_de_vehiculos_hibridos_y_electricos,2019,Enero,Durango,0,0,7,7
Venta_de_vehiculos_hibridos_y_electricos,2019,Febrero,Baja_California Sur,0,0,7,7
Venta_de_vehiculos_hibridos_y_electricos,2019,Mayo,Aguascalientes,0,1,6,7
Venta_de_vehiculos_hibridos_y_electricos,2019,Mayo,Baja_California,0,1,6,7
Venta_de_vehiculos_hibridos_y_electricos,2019,Mayo,Sonora,0,0,7,7
Venta_de_vehiculos_hibridos_y_electricos,2019,Agosto,Chiapas,0,0,7,7
Venta_de_vehiculos_hibridos_y_electricos,2019,Agosto,Colima,1,0,6,7
Venta_de_vehiculos_hibridos_y_electricos,2019,Agosto,Durango,0,0,7,7
Venta_de_vehiculos_hibridos_y_electricos,2019,Septiembre,Zacatecas,0,0,7,7
Venta_de_vehiculos_hibridos_y_electricos,2019,Octubre,Tabasco,0,1,6,7
Venta_de_vehiculos_hibridos_y_electricos,2016,Febrero,Mexico,0,0,6,6
Venta_de_vehiculos_hibridos_y_electricos,2016,Marzo,Sonora,2,0,4,6
Venta_de_vehiculos_hibridos_y_electricos,2016,Marzo,Tlaxcala,1,0,5,6
Venta_de_vehiculos_hibridos_y_electricos,2016,Mayo,Chihuahua,0,0,6,6
Venta_de_vehiculos_hibridos_y_electricos,2016,Mayo,Queretaro_de_Arteaga,0,0,6,6
Venta_de_vehiculos_hibridos_y_electricos,2016,Mayo,Veracruz_de_Ignacio_de_la_Llave,0,0,6,6
Venta_de_vehiculos_hibridos_y_electricos,2016,Junio,Baja_California Sur,0,0,6,6
Venta_de_vehiculos_hibridos_y_electricos,2016,Junio,Chiapas,0,0,6,6
Venta_de_vehiculos_hibridos_y_electricos,2016,Junio,Sonora,0,0,6,6
Venta_de_vehiculos_hibridos_y_electricos,2016,Junio,Yucatan,0,0,6,6
Venta_de_vehiculos_hibridos_y_electricos,2016,Septiembre,Sonora,0,0,6,6
Venta_de_vehiculos_hibridos_y_electricos,2016,Octubre,Baja_California,0,0,6,6
Venta_de_vehiculos_hibridos_y_electricos,2016,Octubre,Coahuila_de_Zaragoza,0,1,5,6
Venta_de_vehiculos_hibridos_y_electricos,2016,Octubre,Morelos,0,1,5,6
Venta_de_vehiculos_hibridos_y_electricos,2016,Octubre,San_Luis_Potosi,0,4,2,6
Venta_de_vehiculos_hibridos_y_electricos,2016,Noviembre,Chihuahua,0,0,6,6
Venta_de_vehiculos_hibridos_y_electricos,2016,Diciembre,Durango,0,0,6,6
Venta_de_vehiculos_hibridos_y_electricos,2016,Diciembre,Michoacan_de_Ocampo,0,1,5,6
Venta_de_vehiculos_hibridos_y_electricos,2017,Enero,Hidalgo,0,1,5,6
Venta_de_vehiculos_hibridos_y_electricos,2017,Enero,Sonora,0,0,6,6
Venta_de_vehiculos_hibridos_y_electricos,2017,Febrero,Aguascalientes,0,0,6,6
Venta_de_vehiculos_hibridos_y_electricos,2017,Febrero,Zacatecas,0,0,6,6
Venta_de_vehiculos_hibridos_y_electricos,2017,Marzo,Baja_California,0,0,6,6
Venta_de_vehiculos_hibridos_y_electricos,2017,Mayo,Baja_California,3,0,3,6
Venta_de_vehiculos_hibridos_y_electricos,2017,Mayo,Tamaulipas,0,0,6,6
Venta_de_vehiculos_hibridos_y_electricos,2017,Junio,Tamaulipas,0,0,6,6
Venta_de_vehiculos_hibridos_y_electricos,2017,Junio,Yucatan,0,0,6,6
Venta_de_vehiculos_hibridos_y_electricos,2017,Julio,Baja_California,0,0,6,6
Venta_de_vehiculos_hibridos_y_electricos,2017,Julio,Chihuahua,0,0,6,6
Venta_de_vehiculos_hibridos_y_electricos,2017,Julio,Tabasco,0,0,6,6
Venta_de_vehiculos_hibridos_y_electricos,2017,Agosto,Chihuahua,0,0,6,6
Venta_de_vehiculos_hibridos_y_electricos,2017,Agosto,Quintana Roo,0,2,4,6
Venta_de_vehiculos_hibridos_y_electricos,2017,Septiembre,Hidalgo,0,0,6,6
Venta_de_vehiculos_hibridos_y_electricos,2017,Septiembre,Sonora,0,1,5,6
Venta_de_vehiculos_hibridos_y_electricos,2017,Septiembre,Yucatan,0,0,6,6
Venta_de_vehiculos_hibridos_y_electricos,2017,Octubre,Coahuila_de_Zaragoza,0,1,5,6
Venta_de_vehiculos_hibridos_y_electricos,2017,Diciembre,Tlaxcala,0,0,6,6
Venta_de_vehiculos_hibridos_y_electricos,2018,Enero,Aguascalientes,0,0,6,6
Venta_de_vehiculos_hibridos_y_electricos,2018,Febrero,Durango,0,0,6,6
Venta_de_vehiculos_hibridos_y_electricos,2018,Febrero,Zacatecas,0,0,6,6
Venta_de_vehiculos_hibridos_y_electricos,2018,Marzo,Quintana Roo,0,1,5,6
Venta_de_vehiculos_hibridos_y_electricos,2018,Abril,Durango,0,0,6,6
Venta_de_vehiculos_hibridos_y_electricos,2018,Mayo,Chiapas,0,0,6,6
Venta_de_vehiculos_hibridos_y_electricos,2018,Mayo,Durango,0,0,6,6
Venta_de_vehiculos_hibridos_y_electricos,2018,Junio,Baja_California Sur,0,0,6,6
Venta_de_vehiculos_hibridos_y_electricos,2018,Junio,Campeche,0,0,6,6
Venta_de_vehiculos_hibridos_y_electricos,2018,Junio,Durango,0,0,6,6
Venta_de_vehiculos_hibridos_y_electricos,2018,Junio,Guerrero,0,0,6,6
Venta_de_vehiculos_hibridos_y_electricos,2018,Agosto,Durango,0,0,6,6
Venta_de_vehiculos_hibridos_y_electricos,2018,Octubre,Durango,2,0,4,6
Venta_de_vehiculos_hibridos_y_electricos,2018,Octubre,Tabasco,0,0,6,6
Venta_de_vehiculos_hibridos_y_electricos,2018,Octubre,Zacatecas,0,0,6,6
Venta_de_vehiculos_hibridos_y_electricos,2018,Diciembre,Chiapas,0,0,6,6
Venta_de_vehiculos_hibridos_y_electricos,2018,Diciembre,Tlaxcala,0,0,6,6
Venta_de_vehiculos_hibridos_y_electricos,2018,Diciembre,Zacatecas,1,0,5,6
Venta_de_vehiculos_hibridos_y_electricos,2019,Enero,Chiapas,0,0,6,6
Venta_de_vehiculos_hibridos_y_electricos,2019,Marzo,Durango,0,0,6,6
Venta_de_vehiculos_hibridos_y_electricos,2019,Marzo,Tlaxcala,0,0,6,6
Venta_de_vehiculos_hibridos_y_electricos,2019,Abril,Durango,0,0,6,6
Venta_de_vehiculos_hibridos_y_electricos,2019,Abril,Sonora,1,0,5,6
Venta_de_vehiculos_hibridos_y_electricos,2019,Abril,Tlaxcala,0,0,6,6
Venta_de_vehiculos_hibridos_y_electricos,2019,Mayo,Tlaxcala,0,0,6,6
Venta_de_vehiculos_hibridos_y_electricos,2019,Junio,Tlaxcala,0,0,6,6
Venta_de_vehiculos_hibridos_y_electricos,2019,Septiembre,Baja_California Sur,0,0,6,6
Venta_de_vehiculos_hibridos_y_electricos,2019,Septiembre,Durango,0,0,6,6
Venta_de_vehiculos_hibridos_y_electricos,2016,Enero,Guanajuato,0,0,5,5
Venta_de_vehiculos_hibridos_y_electricos,2016,Enero,Puebla,0,1,4,5
Venta_de_vehiculos_hibridos_y_electricos,2016,Marzo,San_Luis_Potosi,1,0,4,5
Venta_de_vehiculos_hibridos_y_electricos,2016,Abril,Colima,0,0,5,5
Venta_de_vehiculos_hibridos_y_electricos,2016,Abril,Durango,0,0,5,5
Venta_de_vehiculos_hibridos_y_electricos,2016,Abril,San_Luis_Potosi,0,0,5,5
Venta_de_vehiculos_hibridos_y_electricos,2016,Abril,Sonora,0,0,5,5
Venta_de_vehiculos_hibridos_y_electricos,2016,Abril,Tamaulipas,0,0,5,5
Venta_de_vehiculos_hibridos_y_electricos,2016,Junio,Quintana Roo,0,1,4,5
Venta_de_vehiculos_hibridos_y_electricos,2016,Julio,Baja_California Sur,0,0,5,5
Venta_de_vehiculos_hibridos_y_electricos,2016,Julio,Michoacan_de_Ocampo,0,0,5,5
Venta_de_vehiculos_hibridos_y_electricos,2016,Julio,Oaxaca,0,0,5,5
Venta_de_vehiculos_hibridos_y_electricos,2016,Julio,Quintana Roo,0,0,5,5
Venta_de_vehiculos_hibridos_y_electricos,2016,Julio,Tamaulipas,0,0,5,5
Venta_de_vehiculos_hibridos_y_electricos,2016,Julio,Yucatan,0,0,5,5
Venta_de_vehiculos_hibridos_y_electricos,2016,Agosto,Durango,0,0,5,5
Venta_de_vehiculos_hibridos_y_electricos,2016,Agosto,Guerrero,0,0,5,5
Venta_de_vehiculos_hibridos_y_electricos,2016,Agosto,Tamaulipas,0,0,5,5
Venta_de_vehiculos_hibridos_y_electricos,2016,Septiembre,Coahuila_de_Zaragoza,0,0,5,5
Venta_de_vehiculos_hibridos_y_electricos,2016,Septiembre,Yucatan,0,0,5,5
Venta_de_vehiculos_hibridos_y_electricos,2016,Octubre,Michoacan_de_Ocampo,0,0,5,5
Venta_de_vehiculos_hibridos_y_electricos,2016,Octubre,Oaxaca,0,0,5,5
Venta_de_vehiculos_hibridos_y_electricos,2016,Octubre,Quintana Roo,0,1,4,5
Venta_de_vehiculos_hibridos_y_electricos,2016,Octubre,Sonora,0,0,5,5
Venta_de_vehiculos_hibridos_y_electricos,2016,Noviembre,Oaxaca,0,0,5,5
Venta_de_vehiculos_hibridos_y_electricos,2016,Noviembre,Quintana Roo,0,1,4,5
Venta_de_vehiculos_hibridos_y_electricos,2016,Noviembre,Yucatan,0,0,5,5
Venta_de_vehiculos_hibridos_y_electricos,2017,Enero,Quintana Roo,0,2,3,5
Venta_de_vehiculos_hibridos_y_electricos,2017,Enero,Tamaulipas,0,0,5,5
Venta_de_vehiculos_hibridos_y_electricos,2017,Enero,Yucatan,0,0,5,5
Venta_de_vehiculos_hibridos_y_electricos,2017,Febrero,Colima,0,0,5,5
Venta_de_vehiculos_hibridos_y_electricos,2017,Febrero,Chiapas,0,0,5,5
Venta_de_vehiculos_hibridos_y_electricos,2017,Marzo,Aguascalientes,0,0,5,5
Venta_de_vehiculos_hibridos_y_electricos,2017,Marzo,Guerrero,0,0,5,5
Venta_de_vehiculos_hibridos_y_electricos,2017,Abril,Tamaulipas,1,0,4,5
Venta_de_vehiculos_hibridos_y_electricos,2017,Mayo,Colima,0,0,5,5
Venta_de_vehiculos_hibridos_y_electricos,2017,Mayo,Chihuahua,0,0,5,5
Venta_de_vehiculos_hibridos_y_electricos,2017,Mayo,Guerrero,0,0,5,5
Venta_de_vehiculos_hibridos_y_electricos,2017,Mayo,Sonora,0,0,5,5
Venta_de_vehiculos_hibridos_y_electricos,2017,Mayo,Tabasco,0,0,5,5
Venta_de_vehiculos_hibridos_y_electricos,2017,Junio,Aguascalientes,0,0,5,5
Venta_de_vehiculos_hibridos_y_electricos,2017,Junio,Colima,0,0,5,5
Venta_de_vehiculos_hibridos_y_electricos,2017,Julio,Chiapas,0,0,5,5
Venta_de_vehiculos_hibridos_y_electricos,2017,Agosto,Sonora,0,0,5,5
Venta_de_vehiculos_hibridos_y_electricos,2017,Agosto,Tamaulipas,0,0,5,5
Venta_de_vehiculos_hibridos_y_electricos,2017,Agosto,Zacatecas,0,0,5,5
Venta_de_vehiculos_hibridos_y_electricos,2017,Octubre,Sonora,0,0,5,5
Venta_de_vehiculos_hibridos_y_electricos,2017,Noviembre,Sonora,0,0,5,5
Venta_de_vehiculos_hibridos_y_electricos,2017,Noviembre,Tlaxcala,0,0,5,5
Venta_de_vehiculos_hibridos_y_electricos,2018,Febrero,Chiapas,0,0,5,5
Venta_de_vehiculos_hibridos_y_electricos,2018,Marzo,Sonora,0,0,5,5
Venta_de_vehiculos_hibridos_y_electricos,2018,Marzo,Tabasco,0,0,5,5
Venta_de_vehiculos_hibridos_y_electricos,2018,Abril,Guerrero,0,0,5,5
Venta_de_vehiculos_hibridos_y_electricos,2018,Mayo,Colima,0,0,5,5
Venta_de_vehiculos_hibridos_y_electricos,2018,Mayo,Tlaxcala,0,0,5,5
Venta_de_vehiculos_hibridos_y_electricos,2018,Agosto,Aguascalientes,0,0,5,5
Venta_de_vehiculos_hibridos_y_electricos,2018,Septiembre,Guerrero,0,0,5,5
Venta_de_vehiculos_hibridos_y_electricos,2018,Noviembre,Campeche,0,0,5,5
Venta_de_vehiculos_hibridos_y_electricos,2019,Enero,Guerrero,0,0,5,5
Venta_de_vehiculos_hibridos_y_electricos,2019,Enero,Zacatecas,0,0,5,5
Venta_de_vehiculos_hibridos_y_electricos,2019,Abril,Colima,0,0,5,5
Venta_de_vehiculos_hibridos_y_electricos,2019,Abril,Tabasco,0,0,5,5
Venta_de_vehiculos_hibridos_y_electricos,2019,Abril,Yucatan,1,0,4,5
Venta_de_vehiculos_hibridos_y_electricos,2019,Abril,Zacatecas,0,0,5,5
Venta_de_vehiculos_hibridos_y_electricos,2019,Mayo,Baja_California Sur,0,0,5,5
Venta_de_vehiculos_hibridos_y_electricos,2019,Mayo,Colima,0,0,5,5
Venta_de_vehiculos_hibridos_y_electricos,2019,Mayo,Zacatecas,0,0,5,5
Venta_de_vehiculos_hibridos_y_electricos,2019,Julio,Durango,0,0,5,5
Venta_de_vehiculos_hibridos_y_electricos,2019,Agosto,Guerrero,0,0,5,5
Venta_de_vehiculos_hibridos_y_electricos,2019,Agosto,Tabasco,0,1,4,5
Venta_de_vehiculos_hibridos_y_electricos,2016,Marzo,Colima,1,3,0,4
Venta_de_vehiculos_hibridos_y_electricos,2016,Marzo,Michoacan_de_Ocampo,2,0,2,4
Venta_de_vehiculos_hibridos_y_electricos,2016,Marzo,Quintana Roo,1,0,3,4
Venta_de_vehiculos_hibridos_y_electricos,2016,Abril,Aguascalientes,0,0,4,4
Venta_de_vehiculos_hibridos_y_electricos,2016,Abril,Baja_California,0,0,4,4
Venta_de_vehiculos_hibridos_y_electricos,2016,Abril,Chihuahua,0,0,4,4
Venta_de_vehiculos_hibridos_y_electricos,2016,Abril,Quintana Roo,1,2,1,4
Venta_de_vehiculos_hibridos_y_electricos,2016,Mayo,Hidalgo,0,0,4,4
Venta_de_vehiculos_hibridos_y_electricos,2016,Junio,Baja_California,0,0,4,4
Venta_de_vehiculos_hibridos_y_electricos,2016,Junio,Colima,1,0,3,4
Venta_de_vehiculos_hibridos_y_electricos,2016,Junio,Zacatecas,0,0,4,4
Venta_de_vehiculos_hibridos_y_electricos,2016,Julio,Tlaxcala,0,0,4,4
Venta_de_vehiculos_hibridos_y_electricos,2016,Septiembre,Baja_California Sur,0,0,4,4
Venta_de_vehiculos_hibridos_y_electricos,2016,Septiembre,Tamaulipas,0,0,4,4
Venta_de_vehiculos_hibridos_y_electricos,2016,Octubre,Zacatecas,0,0,4,4
Venta_de_vehiculos_hibridos_y_electricos,2016,Noviembre,Aguascalientes,0,0,4,4
Venta_de_vehiculos_hibridos_y_electricos,2016,Noviembre,Baja_California Sur,0,0,4,4
Venta_de_vehiculos_hibridos_y_electricos,2016,Noviembre,Campeche,0,0,4,4
Venta_de_vehiculos_hibridos_y_electricos,2016,Diciembre,Chiapas,0,0,4,4
Venta_de_vehiculos_hibridos_y_electricos,2016,Diciembre,Guerrero,0,0,4,4
Venta_de_vehiculos_hibridos_y_electricos,2016,Diciembre,Zacatecas,0,0,4,4
Venta_de_vehiculos_hibridos_y_electricos,2017,Enero,Chihuahua,0,0,4,4
Venta_de_vehiculos_hibridos_y_electricos,2017,Marzo,Campeche,0,0,4,4
Venta_de_vehiculos_hibridos_y_electricos,2017,Marzo,Tlaxcala,0,0,4,4
Venta_de_vehiculos_hibridos_y_electricos,2017,Abril,Aguascalientes,0,0,4,4
Venta_de_vehiculos_hibridos_y_electricos,2017,Abril,Baja_California Sur,0,0,4,4
Venta_de_vehiculos_hibridos_y_electricos,2017,Abril,Coahuila_de_Zaragoza,0,0,4,4
Venta_de_vehiculos_hibridos_y_electricos,2017,Abril,Chiapas,0,0,4,4
Venta_de_vehiculos_hibridos_y_electricos,2017,Mayo,Tlaxcala,0,0,4,4
Venta_de_vehiculos_hibridos_y_electricos,2017,Junio,Baja_California,0,0,4,4
Venta_de_vehiculos_hibridos_y_electricos,2017,Junio,Guerrero,0,0,4,4
Venta_de_vehiculos_hibridos_y_electricos,2017,Junio,Tlaxcala,0,0,4,4
Venta_de_vehiculos_hibridos_y_electricos,2017,Julio,Quintana Roo,0,0,4,4
Venta_de_vehiculos_hibridos_y_electricos,2017,Julio,Yucatan,0,0,4,4
Venta_de_vehiculos_hibridos_y_electricos,2017,Agosto,San_Luis_Potosi,0,1,3,4
Venta_de_vehiculos_hibridos_y_electricos,2017,Septiembre,Colima,0,0,4,4
Venta_de_vehiculos_hibridos_y_electricos,2017,Septiembre,San_Luis_Potosi,0,1,3,4
Venta_de_vehiculos_hibridos_y_electricos,2017,Octubre,Chihuahua,0,0,4,4
Venta_de_vehiculos_hibridos_y_electricos,2017,Noviembre,Chihuahua,0,0,4,4
Venta_de_vehiculos_hibridos_y_electricos,2017,Noviembre,San_Luis_Potosi,0,1,3,4
Venta_de_vehiculos_hibridos_y_electricos,2017,Noviembre,Tamaulipas,0,0,4,4
Venta_de_vehiculos_hibridos_y_electricos,2017,Diciembre,Aguascalientes,0,0,4,4
Venta_de_vehiculos_hibridos_y_electricos,2017,Diciembre,Colima,0,0,4,4
Venta_de_vehiculos_hibridos_y_electricos,2018,Enero,Sonora,0,0,4,4
Venta_de_vehiculos_hibridos_y_electricos,2018,Febrero,Tlaxcala,0,0,4,4
Venta_de_vehiculos_hibridos_y_electricos,2018,Marzo,Durango,0,0,4,4
Venta_de_vehiculos_hibridos_y_electricos,2018,Abril,Baja_California Sur,0,0,4,4
Venta_de_vehiculos_hibridos_y_electricos,2018,Abril,Tlaxcala,0,0,4,4
Venta_de_vehiculos_hibridos_y_electricos,2018,Abril,Zacatecas,0,0,4,4
Venta_de_vehiculos_hibridos_y_electricos,2018,Mayo,Aguascalientes,0,0,4,4
Venta_de_vehiculos_hibridos_y_electricos,2018,Junio,Chiapas,0,0,4,4
Venta_de_vehiculos_hibridos_y_electricos,2018,Junio,Tlaxcala,0,0,4,4
Venta_de_vehiculos_hibridos_y_electricos,2018,Junio,Zacatecas,0,0,4,4
Venta_de_vehiculos_hibridos_y_electricos,2018,Julio,Tabasco,0,0,4,4
Venta_de_vehiculos_hibridos_y_electricos,2018,Julio,Zacatecas,0,0,4,4
Venta_de_vehiculos_hibridos_y_electricos,2018,Agosto,Baja_California Sur,0,0,4,4
Venta_de_vehiculos_hibridos_y_electricos,2018,Agosto,Guerrero,0,0,4,4
Venta_de_vehiculos_hibridos_y_electricos,2018,Septiembre,Zacatecas,0,0,4,4
Venta_de_vehiculos_hibridos_y_electricos,2018,Octubre,Chiapas,0,0,4,4
Venta_de_vehiculos_hibridos_y_electricos,2018,Noviembre,Chiapas,0,0,4,4
Venta_de_vehiculos_hibridos_y_electricos,2018,Diciembre,Campeche,0,0,4,4
Venta_de_vehiculos_hibridos_y_electricos,2018,Diciembre,Guerrero,0,0,4,4
Venta_de_vehiculos_hibridos_y_electricos,2019,Febrero,Guerrero,0,0,4,4
Venta_de_vehiculos_hibridos_y_electricos,2019,Febrero,Zacatecas,0,0,4,4
Venta_de_vehiculos_hibridos_y_electricos,2019,Marzo,Guerrero,0,0,4,4
Venta_de_vehiculos_hibridos_y_electricos,2019,Mayo,Chiapas,0,0,4,4
Venta_de_vehiculos_hibridos_y_electricos,2019,Julio,Guerrero,0,0,4,4
Venta_de_vehiculos_hibridos_y_electricos,2019,Agosto,Baja_California Sur,0,0,4,4
Venta_de_vehiculos_hibridos_y_electricos,2019,Agosto,Zacatecas,0,0,4,4
Venta_de_vehiculos_hibridos_y_electricos,2016,Enero,Chihuahua,0,0,3,3
Venta_de_vehiculos_hibridos_y_electricos,2016,Enero,Tlaxcala,0,0,3,3
Venta_de_vehiculos_hibridos_y_electricos,2016,Febrero,Coahuila_de_Zaragoza,0,0,3,3
Venta_de_vehiculos_hibridos_y_electricos,2016,Febrero,Colima,0,3,0,3
Venta_de_vehiculos_hibridos_y_electricos,2016,Febrero,Hidalgo,0,3,0,3
Venta_de_vehiculos_hibridos_y_electricos,2016,Marzo,Baja_California Sur,0,0,3,3
Venta_de_vehiculos_hibridos_y_electricos,2016,Marzo,Morelos,0,0,3,3
Venta_de_vehiculos_hibridos_y_electricos,2016,Marzo,Oaxaca,1,0,2,3
Venta_de_vehiculos_hibridos_y_electricos,2016,Abril,Oaxaca,0,0,3,3
Venta_de_vehiculos_hibridos_y_electricos,2016,Abril,Sinaloa,0,0,3,3
Venta_de_vehiculos_hibridos_y_electricos,2016,Abril,Yucatan,0,0,3,3
Venta_de_vehiculos_hibridos_y_electricos,2016,Mayo,Aguascalientes,0,0,3,3
Venta_de_vehiculos_hibridos_y_electricos,2016,Mayo,Coahuila_de_Zaragoza,0,1,2,3
Venta_de_vehiculos_hibridos_y_electricos,2016,Mayo,Colima,0,0,3,3
Venta_de_vehiculos_hibridos_y_electricos,2016,Mayo,Chiapas,0,0,3,3
Venta_de_vehiculos_hibridos_y_electricos,2016,Mayo,Durango,0,0,3,3
Venta_de_vehiculos_hibridos_y_electricos,2016,Mayo,Oaxaca,0,0,3,3
Venta_de_vehiculos_hibridos_y_electricos,2016,Mayo,Tamaulipas,0,0,3,3
Venta_de_vehiculos_hibridos_y_electricos,2016,Mayo,Yucatan,0,1,2,3
Venta_de_vehiculos_hibridos_y_electricos,2016,Julio,Chiapas,0,0,3,3
Venta_de_vehiculos_hibridos_y_electricos,2016,Julio,Chihuahua,0,0,3,3
Venta_de_vehiculos_hibridos_y_electricos,2016,Julio,Tabasco,0,0,3,3
Venta_de_vehiculos_hibridos_y_electricos,2016,Agosto,Aguascalientes,0,0,3,3
Venta_de_vehiculos_hibridos_y_electricos,2016,Agosto,Colima,0,0,3,3
Venta_de_vehiculos_hibridos_y_electricos,2016,Agosto,Chiapas,0,0,3,3
Venta_de_vehiculos_hibridos_y_electricos,2016,Agosto,Michoacan_de_Ocampo,0,0,3,3
Venta_de_vehiculos_hibridos_y_electricos,2016,Agosto,Oaxaca,0,0,3,3
Venta_de_vehiculos_hibridos_y_electricos,2016,Septiembre,Colima,0,0,3,3
Venta_de_vehiculos_hibridos_y_electricos,2016,Septiembre,Michoacan_de_Ocampo,0,0,3,3
Venta_de_vehiculos_hibridos_y_electricos,2016,Septiembre,San_Luis_Potosi,1,0,2,3
Venta_de_vehiculos_hibridos_y_electricos,2016,Octubre,Chiapas,0,0,3,3
Venta_de_vehiculos_hibridos_y_electricos,2016,Octubre,Durango,0,0,3,3
Venta_de_vehiculos_hibridos_y_electricos,2016,Octubre,Yucatan,0,0,3,3
Venta_de_vehiculos_hibridos_y_electricos,2016,Noviembre,Durango,0,0,3,3
Venta_de_vehiculos_hibridos_y_electricos,2016,Noviembre,Michoacan_de_Ocampo,0,0,3,3
Venta_de_vehiculos_hibridos_y_electricos,2016,Noviembre,Tlaxcala,0,0,3,3
Venta_de_vehiculos_hibridos_y_electricos,2016,Noviembre,Zacatecas,0,0,3,3
Venta_de_vehiculos_hibridos_y_electricos,2016,Diciembre,Tabasco,0,0,3,3
Venta_de_vehiculos_hibridos_y_electricos,2016,Diciembre,Tlaxcala,0,0,3,3
Venta_de_vehiculos_hibridos_y_electricos,2017,Enero,Aguascalientes,0,0,3,3
Venta_de_vehiculos_hibridos_y_electricos,2017,Enero,Colima,0,0,3,3
Venta_de_vehiculos_hibridos_y_electricos,2017,Enero,Tabasco,0,0,3,3
Venta_de_vehiculos_hibridos_y_electricos,2017,Enero,Zacatecas,0,0,3,3
Venta_de_vehiculos_hibridos_y_electricos,2017,Febrero,Durango,0,0,3,3
Venta_de_vehiculos_hibridos_y_electricos,2017,Febrero,Tamaulipas,0,0,3,3
Venta_de_vehiculos_hibridos_y_electricos,2017,Febrero,Tlaxcala,0,0,3,3
Venta_de_vehiculos_hibridos_y_electricos,2017,Marzo,Baja_California Sur,0,0,3,3
Venta_de_vehiculos_hibridos_y_electricos,2017,Abril,Colima,0,0,3,3
Venta_de_vehiculos_hibridos_y_electricos,2017,Abril,Tabasco,0,0,3,3
Venta_de_vehiculos_hibridos_y_electricos,2017,Mayo,Quintana Roo,0,1,2,3
Venta_de_vehiculos_hibridos_y_electricos,2017,Junio,Baja_California Sur,0,0,3,3
Venta_de_vehiculos_hibridos_y_electricos,2017,Junio,Durango,0,0,3,3
Venta_de_vehiculos_hibridos_y_electricos,2017,Julio,Hidalgo,0,0,3,3
Venta_de_vehiculos_hibridos_y_electricos,2017,Julio,Zacatecas,0,0,3,3
Venta_de_vehiculos_hibridos_y_electricos,2017,Agosto,Colima,0,0,3,3
Venta_de_vehiculos_hibridos_y_electricos,2017,Agosto,Chiapas,0,0,3,3
Venta_de_vehiculos_hibridos_y_electricos,2017,Agosto,Tlaxcala,0,0,3,3
Venta_de_vehiculos_hibridos_y_electricos,2017,Septiembre,Tlaxcala,0,0,3,3
Venta_de_vehiculos_hibridos_y_electricos,2017,Octubre,Hidalgo,0,0,3,3
Venta_de_vehiculos_hibridos_y_electricos,2017,Octubre,Tabasco,0,0,3,3
Venta_de_vehiculos_hibridos_y_electricos,2017,Octubre,Tlaxcala,0,0,3,3
Venta_de_vehiculos_hibridos_y_electricos,2017,Noviembre,Colima,0,0,3,3
Venta_de_vehiculos_hibridos_y_electricos,2017,Noviembre,Zacatecas,1,0,2,3
Venta_de_vehiculos_hibridos_y_electricos,2017,Diciembre,Guerrero,0,0,3,3
Venta_de_vehiculos_hibridos_y_electricos,2018,Enero,Zacatecas,0,0,3,3
Venta_de_vehiculos_hibridos_y_electricos,2018,Febrero,Campeche,0,0,3,3
Venta_de_vehiculos_hibridos_y_electricos,2018,Febrero,Tabasco,0,0,3,3
Venta_de_vehiculos_hibridos_y_electricos,2018,Marzo,Chiapas,0,0,3,3
Venta_de_vehiculos_hibridos_y_electricos,2018,Mayo,Tabasco,0,0,3,3
Venta_de_vehiculos_hibridos_y_electricos,2018,Junio,Tabasco,0,0,3,3
Venta_de_vehiculos_hibridos_y_electricos,2018,Julio,Campeche,0,0,3,3
Venta_de_vehiculos_hibridos_y_electricos,2018,Julio,Durango,0,0,3,3
Venta_de_vehiculos_hibridos_y_electricos,2018,Julio,Guerrero,0,0,3,3
Venta_de_vehiculos_hibridos_y_electricos,2018,Septiembre,Baja_California Sur,0,0,3,3
Venta_de_vehiculos_hibridos_y_electricos,2018,Septiembre,Campeche,0,0,3,3
Venta_de_vehiculos_hibridos_y_electricos,2018,Octubre,Campeche,0,0,3,3
Venta_de_vehiculos_hibridos_y_electricos,2018,Diciembre,Durango,0,0,3,3
Venta_de_vehiculos_hibridos_y_electricos,2018,Diciembre,Nayarit,0,0,3,3
Venta_de_vehiculos_hibridos_y_electricos,2019,Enero,Tlaxcala,0,0,3,3
Venta_de_vehiculos_hibridos_y_electricos,2019,Febrero,Chiapas,0,0,3,3
Venta_de_vehiculos_hibridos_y_electricos,2019,Febrero,Tlaxcala,0,0,3,3
Venta_de_vehiculos_hibridos_y_electricos,2019,Abril,Chiapas,0,0,3,3
Venta_de_vehiculos_hibridos_y_electricos,2019,Abril,Guerrero,0,0,3,3
Venta_de_vehiculos_hibridos_y_electricos,2019,Mayo,Campeche,0,0,3,3
Venta_de_vehiculos_hibridos_y_electricos,2019,Mayo,Guerrero,0,0,3,3
Venta_de_vehiculos_hibridos_y_electricos,2019,Julio,Campeche,0,0,3,3
Venta_de_vehiculos_hibridos_y_electricos,2019,Julio,Chiapas,0,0,3,3
Venta_de_vehiculos_hibridos_y_electricos,2019,Julio,Tlaxcala,0,0,3,3
Venta_de_vehiculos_hibridos_y_electricos,2019,Julio,Zacatecas,0,0,3,3
Venta_de_vehiculos_hibridos_y_electricos,2019,Agosto,Campeche,0,0,3,3
Venta_de_vehiculos_hibridos_y_electricos,2019,Septiembre,Guerrero,0,0,3,3
Venta_de_vehiculos_hibridos_y_electricos,2019,Octubre,Campeche,0,0,3,3
Venta_de_vehiculos_hibridos_y_electricos,2016,Enero,Aguascalientes,0,0,2,2
Venta_de_vehiculos_hibridos_y_electricos,2016,Enero,Yucatan,0,0,2,2
Venta_de_vehiculos_hibridos_y_electricos,2016,Febrero,Aguascalientes,0,0,2,2
Venta_de_vehiculos_hibridos_y_electricos,2016,Febrero,Chiapas,0,2,0,2
Venta_de_vehiculos_hibridos_y_electricos,2016,Febrero,Guanajuato,0,0,2,2
Venta_de_vehiculos_hibridos_y_electricos,2016,Febrero,Puebla,0,0,2,2
Venta_de_vehiculos_hibridos_y_electricos,2016,Febrero,Queretaro_de_Arteaga,1,0,1,2
Venta_de_vehiculos_hibridos_y_electricos,2016,Febrero,Quintana Roo,0,2,0,2
Venta_de_vehiculos_hibridos_y_electricos,2016,Febrero,San_Luis_Potosi,0,0,2,2
Venta_de_vehiculos_hibridos_y_electricos,2016,Marzo,Campeche,0,0,2,2
Venta_de_vehiculos_hibridos_y_electricos,2016,Marzo,Chiapas,0,1,1,2
Venta_de_vehiculos_hibridos_y_electricos,2016,Marzo,Tabasco,0,0,2,2
Venta_de_vehiculos_hibridos_y_electricos,2016,Marzo,Zacatecas,0,0,2,2
Venta_de_vehiculos_hibridos_y_electricos,2016,Abril,Baja_California Sur,0,0,2,2
Venta_de_vehiculos_hibridos_y_electricos,2016,Abril,Chiapas,0,0,2,2
Venta_de_vehiculos_hibridos_y_electricos,2016,Mayo,Morelos,0,0,2,2
Venta_de_vehiculos_hibridos_y_electricos,2016,Mayo,Quintana Roo,0,0,2,2
Venta_de_vehiculos_hibridos_y_electricos,2016,Mayo,Sinaloa,0,0,2,2
Venta_de_vehiculos_hibridos_y_electricos,2016,Mayo,Sonora,0,0,2,2
Venta_de_vehiculos_hibridos_y_electricos,2016,Mayo,Tabasco,0,0,2,2
Venta_de_vehiculos_hibridos_y_electricos,2016,Junio,Campeche,0,0,2,2
Venta_de_vehiculos_hibridos_y_electricos,2016,Junio,Tabasco,0,0,2,2
Venta_de_vehiculos_hibridos_y_electricos,2016,Agosto,Baja_California Sur,0,0,2,2
Venta_de_vehiculos_hibridos_y_electricos,2016,Agosto,Campeche,0,0,2,2
Venta_de_vehiculos_hibridos_y_electricos,2016,Agosto,Sonora,0,0,2,2
Venta_de_vehiculos_hibridos_y_electricos,2016,Agosto,Zacatecas,0,0,2,2
Venta_de_vehiculos_hibridos_y_electricos,2016,Septiembre,Chiapas,0,0,2,2
Venta_de_vehiculos_hibridos_y_electricos,2016,Septiembre,Durango,0,0,2,2
Venta_de_vehiculos_hibridos_y_electricos,2016,Septiembre,Oaxaca,1,0,1,2
Venta_de_vehiculos_hibridos_y_electricos,2016,Septiembre,Tabasco,0,0,2,2
Venta_de_vehiculos_hibridos_y_electricos,2016,Septiembre,Tlaxcala,0,0,2,2
Venta_de_vehiculos_hibridos_y_electricos,2016,Septiembre,Zacatecas,0,0,2,2
Venta_de_vehiculos_hibridos_y_electricos,2016,Octubre,Aguascalientes,0,0,2,2
Venta_de_vehiculos_hibridos_y_electricos,2016,Octubre,Baja_California Sur,0,0,2,2
Venta_de_vehiculos_hibridos_y_electricos,2016,Octubre,Colima,0,0,2,2
Venta_de_vehiculos_hibridos_y_electricos,2016,Octubre,Tabasco,0,0,2,2
Venta_de_vehiculos_hibridos_y_electricos,2016,Noviembre,Baja_California,0,0,2,2
Venta_de_vehiculos_hibridos_y_electricos,2016,Noviembre,Colima,0,0,2,2
Venta_de_vehiculos_hibridos_y_electricos,2016,Noviembre,Nayarit,0,0,2,2
Venta_de_vehiculos_hibridos_y_electricos,2016,Diciembre,Aguascalientes,0,0,2,2
Venta_de_vehiculos_hibridos_y_electricos,2016,Diciembre,Baja_California Sur,0,0,2,2
Venta_de_vehiculos_hibridos_y_electricos,2016,Diciembre,Campeche,0,0,2,2
Venta_de_vehiculos_hibridos_y_electricos,2017,Enero,Baja_California Sur,0,0,2,2
Venta_de_vehiculos_hibridos_y_electricos,2017,Enero,Chiapas,0,0,2,2
Venta_de_vehiculos_hibridos_y_electricos,2017,Febrero,Campeche,0,0,2,2
Venta_de_vehiculos_hibridos_y_electricos,2017,Marzo,Durango,0,0,2,2
Venta_de_vehiculos_hibridos_y_electricos,2017,Marzo,Zacatecas,0,0,2,2
Venta_de_vehiculos_hibridos_y_electricos,2017,Abril,Campeche,0,0,2,2
Venta_de_vehiculos_hibridos_y_electricos,2017,Abril,Durango,0,0,2,2
Venta_de_vehiculos_hibridos_y_electricos,2017,Abril,Guerrero,0,0,2,2
Venta_de_vehiculos_hibridos_y_electricos,2017,Abril,Zacatecas,0,0,2,2
Venta_de_vehiculos_hibridos_y_electricos,2017,Mayo,Durango,0,0,2,2
Venta_de_vehiculos_hibridos_y_electricos,2017,Julio,Baja_California Sur,0,0,2,2
Venta_de_vehiculos_hibridos_y_electricos,2017,Julio,Durango,0,0,2,2
Venta_de_vehiculos_hibridos_y_electricos,2017,Julio,Guerrero,0,0,2,2
Venta_de_vehiculos_hibridos_y_electricos,2017,Agosto,Durango,0,0,2,2
Venta_de_vehiculos_hibridos_y_electricos,2017,Septiembre,Baja_California Sur,0,0,2,2
Venta_de_vehiculos_hibridos_y_electricos,2017,Octubre,Chiapas,0,0,2,2
Venta_de_vehiculos_hibridos_y_electricos,2017,Noviembre,Baja_California Sur,0,0,2,2
Venta_de_vehiculos_hibridos_y_electricos,2017,Noviembre,Campeche,0,0,2,2
Venta_de_vehiculos_hibridos_y_electricos,2017,Noviembre,Durango,0,0,2,2
Venta_de_vehiculos_hibridos_y_electricos,2017,Noviembre,Nayarit,0,0,2,2
Venta_de_vehiculos_hibridos_y_electricos,2017,Diciembre,Baja_California Sur,0,0,2,2
Venta_de_vehiculos_hibridos_y_electricos,2017,Diciembre,Chiapas,0,0,2,2
Venta_de_vehiculos_hibridos_y_electricos,2017,Diciembre,Tabasco,0,0,2,2
Venta_de_vehiculos_hibridos_y_electricos,2018,Enero,Durango,0,0,2,2
Venta_de_vehiculos_hibridos_y_electricos,2018,Febrero,Baja_California Sur,0,0,2,2
Venta_de_vehiculos_hibridos_y_electricos,2018,Marzo,Baja_California Sur,0,0,2,2
Venta_de_vehiculos_hibridos_y_electricos,2018,Abril,Campeche,0,0,2,2
Venta_de_vehiculos_hibridos_y_electricos,2018,Abril,Nayarit,0,0,2,2
Venta_de_vehiculos_hibridos_y_electricos,2018,Mayo,Guerrero,0,0,2,2
Venta_de_vehiculos_hibridos_y_electricos,2018,Mayo,Zacatecas,0,0,2,2
Venta_de_vehiculos_hibridos_y_electricos,2018,Julio,Tlaxcala,0,0,2,2
Venta_de_vehiculos_hibridos_y_electricos,2018,Agosto,Tlaxcala,0,0,2,2
Venta_de_vehiculos_hibridos_y_electricos,2018,Agosto,Zacatecas,0,0,2,2
Venta_de_vehiculos_hibridos_y_electricos,2018,Septiembre,Chiapas,0,0,2,2
Venta_de_vehiculos_hibridos_y_electricos,2018,Octubre,Nayarit,1,0,1,2
Venta_de_vehiculos_hibridos_y_electricos,2019,Enero,Nayarit,0,0,2,2
Venta_de_vehiculos_hibridos_y_electricos,2019,Febrero,Campeche,0,0,2,2
Venta_de_vehiculos_hibridos_y_electricos,2019,Febrero,Durango,0,0,2,2
Venta_de_vehiculos_hibridos_y_electricos,2019,Febrero,Nayarit,0,0,2,2
Venta_de_vehiculos_hibridos_y_electricos,2019,Abril,Nayarit,0,0,2,2
Venta_de_vehiculos_hibridos_y_electricos,2019,Junio,Nayarit,0,0,2,2
Venta_de_vehiculos_hibridos_y_electricos,2016,Enero,Baja_California,0,0,1,1
Venta_de_vehiculos_hibridos_y_electricos,2016,Enero,Baja_California Sur,0,0,1,1
Venta_de_vehiculos_hibridos_y_electricos,2016,Enero,Campeche,0,0,1,1
Venta_de_vehiculos_hibridos_y_electricos,2016,Enero,Coahuila_de_Zaragoza,0,0,1,1
Venta_de_vehiculos_hibridos_y_electricos,2016,Enero,Colima,0,1,0,1
Venta_de_vehiculos_hibridos_y_electricos,2016,Enero,Chiapas,0,0,1,1
Venta_de_vehiculos_hibridos_y_electricos,2016,Enero,Durango,0,0,1,1
Venta_de_vehiculos_hibridos_y_electricos,2016,Enero,Hidalgo,0,1,0,1
Venta_de_vehiculos_hibridos_y_electricos,2016,Enero,Michoacan_de_Ocampo,0,0,1,1
Venta_de_vehiculos_hibridos_y_electricos,2016,Enero,Morelos,0,0,1,1
Venta_de_vehiculos_hibridos_y_electricos,2016,Enero,Oaxaca,0,0,1,1
Venta_de_vehiculos_hibridos_y_electricos,2016,Enero,Sinaloa,0,0,1,1
Venta_de_vehiculos_hibridos_y_electricos,2016,Enero,Sonora,0,0,1,1
Venta_de_vehiculos_hibridos_y_electricos,2016,Enero,Veracruz_de_Ignacio_de_la_Llave,0,1,0,1
Venta_de_vehiculos_hibridos_y_electricos,2016,Febrero,Chihuahua,0,0,1,1
Venta_de_vehiculos_hibridos_y_electricos,2016,Febrero,Durango,0,0,1,1
Venta_de_vehiculos_hibridos_y_electricos,2016,Febrero,Oaxaca,0,0,1,1
Venta_de_vehiculos_hibridos_y_electricos,2016,Febrero,Sinaloa,0,0,1,1
Venta_de_vehiculos_hibridos_y_electricos,2016,Febrero,Sonora,1,0,0,1
Venta_de_vehiculos_hibridos_y_electricos,2016,Febrero,Tabasco,0,0,1,1
Venta_de_vehiculos_hibridos_y_electricos,2016,Febrero,Veracruz_de_Ignacio_de_la_Llave,0,1,0,1
Venta_de_vehiculos_hibridos_y_electricos,2016,Febrero,Yucatan,0,0,1,1
Venta_de_vehiculos_hibridos_y_electricos,2016,Marzo,Nayarit,1,0,0,1
Venta_de_vehiculos_hibridos_y_electricos,2016,Abril,Guerrero,0,0,1,1
Venta_de_vehiculos_hibridos_y_electricos,2016,Abril,Michoacan_de_Ocampo,0,0,1,1
Venta_de_vehiculos_hibridos_y_electricos,2016,Abril,Tlaxcala,0,0,1,1
Venta_de_vehiculos_hibridos_y_electricos,2016,Mayo,Baja_California,0,0,1,1
Venta_de_vehiculos_hibridos_y_electricos,2016,Mayo,Baja_California Sur,0,0,1,1
Venta_de_vehiculos_hibridos_y_electricos,2016,Mayo,Guerrero,0,0,1,1
Venta_de_vehiculos_hibridos_y_electricos,2016,Mayo,Michoacan_de_Ocampo,0,0,1,1
Venta_de_vehiculos_hibridos_y_electricos,2016,Junio,Oaxaca,0,0,1,1
Venta_de_vehiculos_hibridos_y_electricos,2016,Julio,Baja_California,0,0,1,1
Venta_de_vehiculos_hibridos_y_electricos,2016,Julio,Campeche,0,0,1,1
Venta_de_vehiculos_hibridos_y_electricos,2016,Julio,Zacatecas,0,0,1,1
Venta_de_vehiculos_hibridos_y_electricos,2016,Agosto,Nayarit,0,0,1,1
Venta_de_vehiculos_hibridos_y_electricos,2016,Agosto,Tabasco,0,0,1,1
Venta_de_vehiculos_hibridos_y_electricos,2016,Agosto,Tlaxcala,0,0,1,1
Venta_de_vehiculos_hibridos_y_electricos,2016,Octubre,Guerrero,0,0,1,1
Venta_de_vehiculos_hibridos_y_electricos,2016,Noviembre,Chiapas,0,0,1,1
Venta_de_vehiculos_hibridos_y_electricos,2016,Noviembre,Guerrero,0,0,1,1
Venta_de_vehiculos_hibridos_y_electricos,2016,Diciembre,Nayarit,0,0,1,1
Venta_de_vehiculos_hibridos_y_electricos,2017,Enero,Campeche,0,0,1,1
Venta_de_vehiculos_hibridos_y_electricos,2017,Enero,Guerrero,0,0,1,1
Venta_de_vehiculos_hibridos_y_electricos,2017,Febrero,Baja_California Sur,0,0,1,1
Venta_de_vehiculos_hibridos_y_electricos,2017,Febrero,Hidalgo,0,0,1,1
Venta_de_vehiculos_hibridos_y_electricos,2017,Febrero,Tabasco,0,0,1,1
Venta_de_vehiculos_hibridos_y_electricos,2017,Marzo,Tabasco,0,0,1,1
Venta_de_vehiculos_hibridos_y_electricos,2017,Abril,Tlaxcala,0,0,1,1
Venta_de_vehiculos_hibridos_y_electricos,2017,Mayo,Baja_California Sur,0,0,1,1
Venta_de_vehiculos_hibridos_y_electricos,2017,Mayo,San_Luis_Potosi,0,0,1,1
Venta_de_vehiculos_hibridos_y_electricos,2017,Junio,Chiapas,0,0,1,1
Venta_de_vehiculos_hibridos_y_electricos,2017,Junio,Nayarit,0,0,1,1
Venta_de_vehiculos_hibridos_y_electricos,2017,Junio,Tabasco,0,0,1,1
Venta_de_vehiculos_hibridos_y_electricos,2017,Junio,Zacatecas,0,0,1,1
Venta_de_vehiculos_hibridos_y_electricos,2017,Julio,Campeche,0,0,1,1
Venta_de_vehiculos_hibridos_y_electricos,2017,Julio,Colima,0,0,1,1
Venta_de_vehiculos_hibridos_y_electricos,2017,Julio,Tlaxcala,0,0,1,1
Venta_de_vehiculos_hibridos_y_electricos,2017,Agosto,Baja_California Sur,0,0,1,1
Venta_de_vehiculos_hibridos_y_electricos,2017,Agosto,Campeche,0,0,1,1
Venta_de_vehiculos_hibridos_y_electricos,2017,Agosto,Guerrero,0,0,1,1
Venta_de_vehiculos_hibridos_y_electricos,2017,Agosto,Nayarit,0,0,1,1
Venta_de_vehiculos_hibridos_y_electricos,2017,Septiembre,Campeche,0,0,1,1
Venta_de_vehiculos_hibridos_y_electricos,2017,Septiembre,Durango,0,0,1,1
Venta_de_vehiculos_hibridos_y_electricos,2017,Septiembre,Guerrero,0,0,1,1
Venta_de_vehiculos_hibridos_y_electricos,2017,Septiembre,Tabasco,0,0,1,1
Venta_de_vehiculos_hibridos_y_electricos,2017,Septiembre,Zacatecas,0,0,1,1
Venta_de_vehiculos_hibridos_y_electricos,2017,Octubre,Aguascalientes,0,0,1,1
Venta_de_vehiculos_hibridos_y_electricos,2017,Octubre,Baja_California Sur,0,0,1,1
Venta_de_vehiculos_hibridos_y_electricos,2017,Octubre,Colima,0,0,1,1
Venta_de_vehiculos_hibridos_y_electricos,2017,Octubre,Durango,0,0,1,1
Venta_de_vehiculos_hibridos_y_electricos,2017,Octubre,Guerrero,0,0,1,1
Venta_de_vehiculos_hibridos_y_electricos,2017,Octubre,Zacatecas,0,0,1,1
Venta_de_vehiculos_hibridos_y_electricos,2017,Noviembre,Tabasco,0,0,1,1
Venta_de_vehiculos_hibridos_y_electricos,2017,Diciembre,Campeche,0,0,1,1
Venta_de_vehiculos_hibridos_y_electricos,2018,Enero,Baja_California Sur,0,0,1,1
Venta_de_vehiculos_hibridos_y_electricos,2018,Enero,Chiapas,0,0,1,1
Venta_de_vehiculos_hibridos_y_electricos,2018,Febrero,Guerrero,0,0,1,1
Venta_de_vehiculos_hibridos_y_electricos,2018,Abril,Chiapas,0,0,1,1
Venta_de_vehiculos_hibridos_y_electricos,2018,Abril,Tabasco,0,0,1,1
Venta_de_vehiculos_hibridos_y_electricos,2018,Julio,Baja_California Sur,0,0,1,1
Venta_de_vehiculos_hibridos_y_electricos,2018,Julio,No especificado,1,0,0,1
Venta_de_vehiculos_hibridos_y_electricos,2018,Agosto,Campeche,0,0,1,1
Venta_de_vehiculos_hibridos_y_electricos,2018,Agosto,Chiapas,0,0,1,1
Venta_de_vehiculos_hibridos_y_electricos,2018,Agosto,Nayarit,0,0,1,1
Venta_de_vehiculos_hibridos_y_electricos,2018,Septiembre,Nayarit,0,0,1,1
Venta_de_vehiculos_hibridos_y_electricos,2019,Enero,Campeche,0,0,1,1
Venta_de_vehiculos_hibridos_y_electricos,2019,Marzo,Campeche,0,0,1,1
Venta_de_vehiculos_hibridos_y_electricos,2019,Marzo,Nayarit,0,0,1,1
Venta_de_vehiculos_hibridos_y_electricos,2019,Mayo,Durango,0,0,1,1
Venta_de_vehiculos_hibridos_y_electricos,2019,Septiembre,Campeche,0,0,1,1
Venta_de_vehiculos_hibridos_y_electricos,2019,Septiembre,Nayarit,0,0,1,1
Venta_de_vehiculos_hibridos_y_electricos,2019,Octubre,Nayarit,0,0,1,1
Venta_de_vehiculos_hibridos_y_electricos,2016,Enero,Guerrero,0,0,0,0
Venta_de_vehiculos_hibridos_y_electricos,2016,Enero,Nayarit,0,0,0,0
Venta_de_vehiculos_hibridos_y_electricos,2016,Enero,Queretaro_de_Arteaga,0,0,0,0
Venta_de_vehiculos_hibridos_y_electricos,2016,Enero,Quintana Roo,0,0,0,0
Venta_de_vehiculos_hibridos_y_electricos,2016,Enero,San_Luis_Potosi,0,0,0,0
Venta_de_vehiculos_hibridos_y_electricos,2016,Enero,Tabasco,0,0,0,0
Venta_de_vehiculos_hibridos_y_electricos,2016,Enero,Tamaulipas,0,0,0,0
Venta_de_vehiculos_hibridos_y_electricos,2016,Enero,Zacatecas,0,0,0,0
Venta_de_vehiculos_hibridos_y_electricos,2016,Enero,No especificado,0,0,0,0
Venta_de_vehiculos_hibridos_y_electricos,2016,Febrero,Baja_California,0,0,0,0
Venta_de_vehiculos_hibridos_y_electricos,2016,Febrero,Baja_California Sur,0,0,0,0
Venta_de_vehiculos_hibridos_y_electricos,2016,Febrero,Campeche,0,0,0,0
Venta_de_vehiculos_hibridos_y_electricos,2016,Febrero,Guerrero,0,0,0,0
Venta_de_vehiculos_hibridos_y_electricos,2016,Febrero,Michoacan_de_Ocampo,0,0,0,0
Venta_de_vehiculos_hibridos_y_electricos,2016,Febrero,Morelos,0,0,0,0
Venta_de_vehiculos_hibridos_y_electricos,2016,Febrero,Nayarit,0,0,0,0
Venta_de_vehiculos_hibridos_y_electricos,2016,Febrero,Tamaulipas,0,0,0,0
Venta_de_vehiculos_hibridos_y_electricos,2016,Febrero,Tlaxcala,0,0,0,0
Venta_de_vehiculos_hibridos_y_electricos,2016,Febrero,Zacatecas,0,0,0,0
Venta_de_vehiculos_hibridos_y_electricos,2016,Febrero,No especificado,0,0,0,0
Venta_de_vehiculos_hibridos_y_electricos,2016,Marzo,Guerrero,0,0,0,0
Venta_de_vehiculos_hibridos_y_electricos,2016,Marzo,No especificado,0,0,0,0
Venta_de_vehiculos_hibridos_y_electricos,2016,Abril,Campeche,0,0,0,0
Venta_de_vehiculos_hibridos_y_electricos,2016,Abril,Tabasco,0,0,0,0
Venta_de_vehiculos_hibridos_y_electricos,2016,Agosto,Quintana Roo,0,0,0,0
Venta_de_vehiculos_hibridos_y_electricos,2016,Noviembre,Tabasco,0,0,0,0
Venta_de_vehiculos_hibridos_y_electricos,2016,Diciembre,Colima,0,0,0,0
Venta_de_vehiculos_hibridos_y_electricos,2017,Enero,Nayarit,0,0,0,0
Venta_de_vehiculos_hibridos_y_electricos,2017,Enero,Tlaxcala,0,0,0,0
Venta_de_vehiculos_hibridos_y_electricos,2017,Febrero,Guerrero,0,0,0,0
Venta_de_vehiculos_hibridos_y_electricos,2017,Febrero,Nayarit,0,0,0,0
Venta_de_vehiculos_hibridos_y_electricos,2017,Marzo,Nayarit,0,0,0,0
Venta_de_vehiculos_hibridos_y_electricos,2017,Abril,Nayarit,0,0,0,0
Venta_de_vehiculos_hibridos_y_electricos,2017,Mayo,Campeche,0,0,0,0
Venta_de_vehiculos_hibridos_y_electricos,2017,Mayo,Chiapas,0,0,0,0
Venta_de_vehiculos_hibridos_y_electricos,2017,Mayo,Nayarit,0,0,0,0
Venta_de_vehiculos_hibridos_y_electricos,2017,Mayo,Zacatecas,0,0,0,0
Venta_de_vehiculos_hibridos_y_electricos,2017,Junio,Campeche,0,0,0,0
Venta_de_vehiculos_hibridos_y_electricos,2017,Julio,Aguascalientes,0,0,0,0
Venta_de_vehiculos_hibridos_y_electricos,2017,Julio,Nayarit,0,0,0,0
Venta_de_vehiculos_hibridos_y_electricos,2017,Agosto,Tabasco,0,0,0,0
Venta_de_vehiculos_hibridos_y_electricos,2017,Septiembre,Aguascalientes,0,0,0,0
Venta_de_vehiculos_hibridos_y_electricos,2017,Septiembre,Chiapas,0,0,0,0
Venta_de_vehiculos_hibridos_y_electricos,2017,Septiembre,Nayarit,0,0,0,0
Venta_de_vehiculos_hibridos_y_electricos,2017,Octubre,Campeche,0,0,0,0
Venta_de_vehiculos_hibridos_y_electricos,2017,Octubre,Nayarit,0,0,0,0
Venta_de_vehiculos_hibridos_y_electricos,2017,Noviembre,Chiapas,0,0,0,0
Venta_de_vehiculos_hibridos_y_electricos,2017,Noviembre,Guerrero,0,0,0,0
Venta_de_vehiculos_hibridos_y_electricos,2017,Diciembre,Durango,0,0,0,0
Venta_de_vehiculos_hibridos_y_electricos,2017,Diciembre,Nayarit,0,0,0,0
Venta_de_vehiculos_hibridos_y_electricos,2017,Diciembre,Zacatecas,0,0,0,0
Venta_de_vehiculos_hibridos_y_electricos,2018,Enero,Campeche,0,0,0,0
Venta_de_vehiculos_hibridos_y_electricos,2018,Enero,Guerrero,0,0,0,0
Venta_de_vehiculos_hibridos_y_electricos,2018,Enero,Nayarit,0,0,0,0
Venta_de_vehiculos_hibridos_y_electricos,2018,Febrero,Nayarit,0,0,0,0
Venta_de_vehiculos_hibridos_y_electricos,2018,Marzo,Campeche,0,0,0,0
Venta_de_vehiculos_hibridos_y_electricos,2018,Marzo,Nayarit,0,0,0,0
Venta_de_vehiculos_hibridos_y_electricos,2018,Mayo,Nayarit,0,0,0,0
Venta_de_vehiculos_hibridos_y_electricos,2018,Junio,Nayarit,0,0,0,0
Venta_de_vehiculos_hibridos_y_electricos,2018,Julio,Nayarit,0,0,0,0
Venta_de_vehiculos_hibridos_y_electricos,2018,Agosto,No especificado,0,0,0,0
Venta_de_vehiculos_hibridos_y_electricos,2018,Septiembre,No especificado,0,0,0,0
Venta_de_vehiculos_hibridos_y_electricos,2018,Octubre,No especificado,0,0,0,0
Venta_de_vehiculos_hibridos_y_electricos,2018,Noviembre,Nayarit,0,0,0,0
Venta_de_vehiculos_hibridos_y_electricos,2018,Noviembre,No especificado,0,0,0,0
Venta_de_vehiculos_hibridos_y_electricos,2018,Diciembre,No especificado,0,0,0,0
Venta_de_vehiculos_hibridos_y_electricos,2019,Enero,No especificado,0,0,0,0
Venta_de_vehiculos_hibridos_y_electricos,2019,Febrero,No especificado,0,0,0,0
Venta_de_vehiculos_hibridos_y_electricos,2019,Marzo,No especificado,0,0,0,0
Venta_de_vehiculos_hibridos_y_electricos,2019,Abril,Campeche,0,0,0,0
Venta_de_vehiculos_hibridos_y_electricos,2019,Abril,No especificado,0,0,0,0
Venta_de_vehiculos_hibridos_y_electricos,2019,Mayo,Nayarit,0,0,0,0
Venta_de_vehiculos_hibridos_y_electricos,2019,Mayo,No especificado,0,0,0,0
Venta_de_vehiculos_hibridos_y_electricos,2019,Junio,No especificado,0,0,0,0
Venta_de_vehiculos_hibridos_y_electricos,2019,Julio,Nayarit,0,0,0,0
Venta_de_vehiculos_hibridos_y_electricos,2019,Julio,No especificado,0,0,0,0
Venta_de_vehiculos_hibridos_y_electricos,2019,Agosto,Nayarit,0,0,0,0
Venta_de_vehiculos_hibridos_y_electricos,2019,Agosto,No especificado,0,0,0,0
Venta_de_vehiculos_hibridos_y_electricos,2019,Septiembre,No especificado,0,0,0,0
Venta_de_vehiculos_hibridos_y_electricos,2019,Octubre,No especificado,0,0,0,0
